000000000000000000000000000000000000000,
0000000000000000000000000000000000000000
0000000000000000000000000000000000000000
0003333333333333333333333333330000000000
0032222222222222222222222222223000000000
0032222222222222222222222222223000000000
0032222222233333333222222222223000000000
0032222222230000003222222222223000000000
0032222222230000000322222222223000000000
0032222222230000000322222222223333333000
0032222222230000000322222222222222222300
0032222222230000000322222222222222222300
0032222222233333333322222222222222222300
0032222222222222222222222222222222222300
0032222222222222222222222222222222222300
0032222222222222222222222222222222222300
0032222222222222222222222222222222333000
0003333333333333333333333333322222300000
0000000000000000000000000000322222300000
0000000000000000000000000030322222300000
0000000000000000000000003323322222300000
0000000000000000000000032222222222300000
0000000000000000000000332222222222300000
0000000000000000000003222222222222300000
0000000000000000000033222222222222300000
0000000000000000000322222222222222300000
0000000000000000003322222222222222300000
0000000000000000032222222222222222300000
0000000000000000032222222222222222300000
0000000000000000032222223333322222300000
0000000000000000032222230000322222300000
0000000000000000032222230000322222300000
0000000000000000032222230000322222300000
0000000000000000032222223303322222300000
0000000000000000032222222232222222300000
0000000000000000032222222222222222300000
0000000000000000032222222222222222300000
0000000000000000003333333333333333000000
0000000000000000000000000000000000000000
0000000000000000000000000000000000000000
