000000000000000000000000000000000000000ý
0000333333333333333333333333333333333300
0003222222222222222222222222222222222230
0032222222222222222222222222222222222223
0032211111111111111111111111111111111223
0032210000000000000000000000000000001223
0032210000000000000000000000000000001223
0032210000000000000000000000000000001223
0032210000000000000000000000000000001223
0032210000000000000000000000000000001223
0032210000000000000000000000000000001223
0032210000000000000000000000000000001223
0032210000000000000000000000000000001223
0032210000000000000000000000000000001223
0032210000000000000000000000000000001223
0032210000000000000000000000000000001223
0032210000000000000000000000000000001223
0032210000000000000000000000000000001223
0032210000000000000000000000000000001223
0032210000000000000000000000000000001223
0032210000000000000000000000000000001223
0032210000000000000000000000000000001223
0032210000000000000000000000000000001223
0032210000000000000000000000000000001223
0032210000000000000000000000000000001223
0032210000000000000000000000000000001223
0032210000000000000000000000000000001223
0032210000000000000000000000000000001223
0032210000000000000000000000000000001223
0032210000000000000000000000000000001223
0032210000000000000000000000000000001223
0032210000000000000000000000000000001223
0032210000000000000000000000000000001223
0032210000000000000000000000000000001223
0032210000000000000000000000000000001223
0032211000000000000000000000000000001223
0032222111111111111111111111111111111223
0032222222222222222222222222222222222223
0001222222222222222222222222222222222230
0000333333333333333333333333333333333300
