000000000000000000000000000000000000000W
0000000000000000000000000000000000000000
0000000000000000000000000000000000000000
0003333333333333333333333333330000000000
0032222222222222222222222222223000000000
0321111111111111111111222222230000000000
0321000000000000000001222222230000000000
0321000000000000000001222222230000000000
0321000000000000000001222222230000000000
0321000000000000000001222222223333333000
0321000000000000000001222222222222222300
0321000000000000000001222222211111112300
0321000000000000000000111111100000012300
0321000000000000000000000000000000012300
0321000000000000000000000000000001112300
0321111111111111111111111111110012222300
0323222222222222222222222222221012333000
0030333333333333333333333333321012300000
0000000000000000000000000000321012300000
0000000000000000000000000000321012300000
0000000000000000000000000333321012300000
0000000000000000000000003222221012300000
0000000000000000000000032111110012300000
0000000000000000000000321000000012300000
0000000000000000000003210000000012300000
0000000000000000000032100000000012300000
0000000000000000000321000000000012300000
0000000000000000003210000000000012300000
0000000000000000032100000000000012300000
0000000000000000321000000000000012300000
0000000000000000321000000000000012300000
0000000000000000321000000000000012300000
0000000000000000321000000000000012300000
0000000000000000321000000000000012300000
0000000000000000321000000000000012300000
0000000000000000321000000000000012300000
0000000000000000321111111111111111000000
0000000000000000031222222222222222300000
0000000000000000000333333333333333000000
0000000000000000000000000000000000000000
