000000000000000000000000000000000000000Ê
0000000000000000000000300000000000000000
0003333333333333333333233333333333333300
0032222222222222222222222222222222222230
0322222222222222222222222222222222222230
0322222222222222222222222222222222222230
0322222222222222222222222222222222222230
0322222222222222222222222222222222222230
0322222222222222212222222222222222222230
0322222111111111112222222222222222222230
0322222210000000012222222222222222222230
0322222210000000012222222222222222222230
0322222210000000012222222222222222222230
0322222210000000012222222222222222222230
0322222210000000012222222222222222222230
0322222210000000012222222222222222222230
0322222210000000012222222222222222222230
0322222210000000012222222222222222222230
0322222210000000012222222222222222222223
0322222210000000012222222222222222222223
0322222210000000012222222222222222222223
0322222210000000012222222222222222222223
0322222210000000012222222222222221222223
0322222100000000001111111111111111222223
0322222100000000000000000000000001222223
0322222100000000000000000000000001222223
0322222100000000000000000000000001222223
0322222100000000000000000000000001222223
0322222100000000000000000000000001222223
0322222100000000000000000000000001222223
0322222111111111111111111111111111122223
0322222222222222222222222222222222222223
0322222222222222222222222222222222222223
0322222222222222222222222222222222222223
0322222222222222222222222222222222222223
0032222222222222222222222222222222222223
0003333333333333333333333333333333333330
0000000000000000000000000000000000000000
0000000000000000000000000000000000000000
0000000000000000000000000000000000000000
