000000000000000000000000000000000000000
0000000000000000000000000000000000000000
0003333333333333333333333333330000000000
0032222222222222222222222222223000000000
0032222222222222222222222222223000000000
0032222222222222222222222222223000000000
0032222222233333333222222222223000000000
0032222222230000003222222222222300000000
0032222222230000000322222222222333333000
0032222222230000000322222222222222222300
0032222222230000000322222222222222222300
0032222222230000000322222222222222222300
0032222222223333333322222222222222222300
0032222222222222222222222222222222222300
0032222222222222222222222222222222222300
0032222222222222222222222222222222222300
0003333333333333333333333333322222333000
0000000000000000000000000000322222300000
0000000000000000000000000000322222300000
0000000000000000000000000000322222300000
0000000000000000000000003333322222300000
0000000000000000000000032222222222300000
0000000000000000000000322222222222300000
0000000000000000000003222222222222300000
0000000000000000000032222222222222300000
0000000000000000000322222222222222300000
0000000000000000003222222222222222300000
0000000000000000032222222222222222300000
0000000000000000032222223333222222300000
0000000000000000032222230000322222300000
0000000000000000032222230000322222300000
0000000000000000032222230000322222300000
0000000000000000032222230000322222300000
0000000000000000032222223333222222300000
0000000000000000032222222222222222300000
0000000000000000032222222222222222300000
0000000000000000032222222222222222300000
0000000000000000003333333333333333000000
0000000000000000000000000000000000000000
0000000000000000000000000000000000000000
