0000000000000000000000000000000000000000
0000000000000000000000000000000000000000
0000000000000000000000000000000000000000
0000333333333333333333333333333000000000
0003222222222222222222222222222300000000
0003222222222222222222222222222300000000
0003222222223333333322222222222300000000
0003222222223000000322222222222300000000
0003222222223000000322222222222300000000
0003222222223000000322222222222333333000
0003222222223000000322222222222222222300
0003222222223000000322222222222222222300
0003222222223333333322222222222222222300
0003222222222222222222222222222222222300
0003222222222222222222222222222222222300
0003222222222222222222222222222222222300
0003222222222222222222222222222222222300
0000333333333333333333333333322222233000
0000000000000000000000000000322222230000
0000000000000000000000000000322222230000
0000000000000000000000000333322222230000
0000000000000000000000003222222222230000
0000000000000000000000032222222222230000
0000000000000000000000322222222222230000
0000000000000000000003222222222222230000
0000000000000000000032222222222222230000
0000000000000000003322222222222222230000
0000000000000000032222222222222222230000
0000000000000000032222222222222222230000
0000000000000000032222223333322222230000
0000000000000000032222223000322222230000
0000000000000000032222223000322222230000
0000000000000000032222223000322222230000
0000000000000000032222223000322222230000
0000000000000000032222222333222222230000
0000000000000000032222222222222222230000
0000000000000000032222222222222222230000
0000000000000000003333333333333333300000
0000000000000000000000000000000000000000
0000000000000000000000000000000000000000
