000000000000000000000000000000000000000¶
0000000000000000000000000000000000000000
0000000330033333333300000000000000000000
0000003223322222222230000000000000000000
0000003222222222222230000000000000000000
0000000322222222222230000000000000000000
0000000323222233222230000000000000000000
0000000322222222222230000000000000000000
0000000322222222222223000033333333000000
0000000322222222222223033322222222300000
0000000323222232222223322222222222300000
0000000322222233222223032222222222300000
0000000322222222222223322222222222300000
0000000322222222222223322222222222300000
0000000322222222222223322222222222300000
0000000322222222222223322222222222300000
0000000322222222222223322222222222300000
0000000322222222222223323222222222300000
0000000322222222222223322222222222300000
0000000322223222222223033222222222300000
0000000322223222222223322222222222300000
0000000033330322222223322222222222300000
0000000000000322222223323222222222300000
0000000000000322222223033222222333000000
0000000000000322222223322222222300000000
0000000000000322233333322222222300000000
0330000333300322222222222222222300000000
3223003222230322222222222222222333333300
3223032222233322222222222222222222222230
3223332222222222222222222222222222333330
3222222222222222222222222222222222222223
3222222222222222222333322222222222222223
0333322333333222222303322222222222222223
0000032222233222222332322222222222222223
0000032333303222222332322222222222222223
0000032300003222222222322222222333333330
0000003000003222222322333333333000000000
0000000000000322222322222230000000000000
0000000000000322222322222230000000000000
0000000000000033333033333300000000000000
