0000000000000000000000000000000000000000
0000000000000000000000000000000000000000
0000000000000000000000000000000000000000
0003333333333333333333333333300000000000
0032222222222222222222222222230000000000
0321111111111111111112222222223000000000
0321000000000000000012222222223000000000
0321000000000000000012222222223000000000
0321000000000000000012222222223000000000
0321000000000000000012222222223333333000
0321000000000000000012222222222222222300
0321000000000000000012222222211111112300
0321000000000000000001111111100000012300
0321000000000000000000000000000000012300
0321000000000000000000000000000000012300
0321111111111111111111111111100001112300
0322222222222222222222222222210012223000
0033333333333333333333333333210012330000
0000000000000000000000000003210012300000
0000000000000000000000000003210012300000
0000000000000000000000003333210012300000
0000000000000000000000032222210012300000
0000000000000000000000321111100012300000
0000000000000000000003221000000012300000
0000000000000000000032110000000012300000
0000000000000000000322100000000012300000
0000000000000000003211000000000012300000
0000000000000000032210000000000012300000
0000000000000000321100000000000012300000
0000000000000000321000000000000012300000
0000000000000000321000000000000012300000
0000000000000000321000000000000012300000
0000000000000000321000000000000012300000
0000000000000000321000000000000012300000
0000000000000000321000000000000012300000
0000000000000000321111111111111112300000
0000000000000000322222222222222223000000
0000000000000000033333333333333330000000
0000000000000000000000000000000000000000
0000000000000000000000000000000000000000
