0000000000000000000000000000000000000000
0000000000000000000000000000000000000000
0000000000000000000000000000000000000000
0000000000000000000000000000000000000000
0002222222222222222221444444400000000000
0030000000000000000001144444410000000000
0030000000000000000001114444310000000000
0030000000000000000001111443310000000000
0030000000000000000001112233310000000000
0030000000000000000001122233310000000000
0030000000000000000001222223322222221000
0030000000000000000002222222300000001000
0030000000000000000000000000000000001000
0030000000000000000000000000000000001000
0030000000000000000000000000000000001000
0030000000000000000000000000000000001000
0034444444444444444444444444400001440000
0000000000000000000000000000300001000000
0000000000000000000000000000300001000000
0000000000000000000000000000300001000000
0000000000000000000000000000300001000000
0000000000000000000000002222300001000000
0000000000000000000000030000000001000000
0000000000000000000000230000000001000000
0000000000000000000003000000000001000000
0000000000000000000023000000000001000000
0000000000000000000300000000000001000000
0000000000000000002300000000000001000000
0000000000000000030000000000000001000000
0000000000000000030000000000000001000000
0000000000000000030000000000000001000000
0000000000000000030000000000000001000000
0000000000000000030000000000000001000000
0000000000000000030000000000000001000000
0000000000000000030000000000000001000000
0000000000000000030000000000000001000000
0000000000000000034444444444444440000000
0000000000000000000000000000000000000000
0000000000000000000000000000000000000000
0000000000000000000000000000000000000000
