00000000000000000000000000000000000000000000000000000000003330000000000000000001
00000000000000000000000000000000000000000000000000000000000100000000000000000000
00000000000000000000000000000000000000000000000000000000000000000000000000000000
00000000000000000000000000000000000000000000000000000000000000000000000000000000
00000000000000000000000000000000000000000000000000000000000000000000000000000000
00000000000000000000000000000000000000000000000000000000000000000000000000000000
00000000000000000000000000000000000000000000000000000000000000000000000000000000
00000000000000000000000000000000000000000000000000000000000000000000000000000000
00000000000000000000000000000000000000000000000000000000000000000000000000000000
00000000000000000000000000000000000000000000003300330000000000000000000000000000
00000000000000000000333000000000000000003333332233223333333330000000000000000000
00000000000000000001222300000000000000032222222222222222222223000000000000000000
00000000000000000001222300000000000000032222222222222222222223000000000000000000
00000000000000000001222300000000000000032222222222222222222223000000000000000000
00000000000000000001222300000000000000032222222222222222222223000000000000000000
00000000000000000001222300000000000000032222222222222222222223000000000000000000
00000000000000000001222300000000000000032222222222222222222223000000000000000000
00000000000000000000122300000000000000032222222222222222222223000000000000000000
00000000000000000000122300000000000000032222222222222222222221000000000000000000
00000000000000000000122300000000000000032222222222222222222221000000000000000000
00000000000000000000122300000000000000032222222333333333331221000000000000000000
00000000000000000000122300000000000000032222233000000000003221000000000000000000
00000000000000000000122300000000000000032222230000000000003221000000000000000000
00000000000000000000122300000000000000032222230000000000003221000000000000000000
00000000000000000000122300000000000000032222230000000000003221000000000000000000
00000000000000000000322333333333333333332222230000000000003221000000000000000000
00000000000000000000322222222222222222222222230000000000003221000000000000000000
00000000000000000000322222222222222222222222230000000000003221000000000000000000
00000000000000000000033312222222222222222222230000000000003221000000000000000000
00000000000000000000000032222222222222222222230000000000003221000000000000000000
00000000000000000000000032222222222222222222230000000000003221000000000000000000
00000000000000000000000032222222222222222222230000000000003221000000000000000000
00000000000000000000000032222222222222222222330000000000003221000000000000000000
00000000000000000000000003333333333333033333300000000000003221000000000000000000
00000000000000000000000000000000000000000000000000000000003221000000000000000000
00000000000000000000000000000000000000000000000000000000003221000000000000000000
00000000000000000000000000000000000000000000000000000000003221000000000000000000
00000000000000000000000000000000000000000000000000000000003221000000000000000000
00000000000000000000000000000000000000000000000000000000003221000000000000000000
00000000000000000000000000000000000000000000000000000000003221000000000000000000
00000000000000000000000000000000000000000000000000000000003221000000000000000000
00000000000000000000000000000000000000000000000000000000003221000000000000000000
00000000000000000000000000000000000000000000000000000000001221000000000000000000
00000000000000000000000000000000000000000000000000000000001221000000000000000000
00000000000000000000000000000000000000000000000000000000001221000000000000000000
00000000000000000000000000000000000000000000000000000000000331000000000000000000
00000000000000000000000000000000000000000000000000000000000333000000000000000000
00000000000000000000000000000000000000000000000000000000000333000000000000000000
00000000000000000000000000000000000000000000000000000000000333000000000000000000
00000000000000000000000000000000000000000000000000000000000333000000000000000000
00000000000000000000000000000000000000000000000000000000000333000000000000000000
00000000000000000000000000000000000000000000000000000000000333000000000000000000
00000000000000000000000000000000000000000000000000000000000333000000000000000000
00000000000000000000000000000000000000000000000000000000000333000000000000000000
00000000000000000000000000000000000000000000000000000000000333000000000000000000
00000000000000000000000000000000000000000000000000000000000121000000000000000000
00000000000000000000000000000000000000000000000000000000000121000000000000000000
00000000000000000000000000000000000000000000000000000000000121000000000000000000
00000000000000000000000000000000000000000000000000000000000121000000000000000000
00000000000000000000000000000000000000000000000000000000000121000000000000000000
00000000000000000000000000000000000000000000000000000000000121000000000000000000
00000000000000000000000000000000000000000000000000000000000121000000000000000000
00000000000000000000000000000000000000000000000000000000000121000000000000000000
00000000000000000000000000000000000000000000000000000000000121000000000000000000
00000000000000000000000000000000000000000000000000000000000121000000000000000000
00000000000000000000000000000000000000000000000000000000000121000000000000000000
00000000000000000000000000000000000000000000000000000000000121000000000000000000
00000000000000000000000000000000000000000000000000000000000121000000000000000000
00000000000000000000000000000000000000000000000000000000000121000000000000000000
00000000000000000000000000000000000000000000000000000000000121000000000000000000
00000000000000000000000000000000000000000000000000000000000121000000000000000000
00000000000000000000000000000000000000000000000000000000000121000000000000000000
00000000000000000000000000000000000000000000000000000000000121000000000000000000
00000000000000000000000000000000000000000000000000000000000121000000000000000000
00000000000000000000000000000000000000000000000000000000000131000000000000000000
00000000000000000000000000000000000000000000000000000000000333000000000000000000
00000000000000000000000000000000000000000000000000000000000333000000000000000000
00000000000000000000000000000000000000000000000000000000000333000000000000000000
00000000000000000000000000000000000000000000000000000000000333000000000000000000
00000000000000000000000000000000000000000000000000000000000333000000000000000000
