00000000000000000000000000000000000000000000000000000000000000000000000000000000
00000000000000000000000000000000000000000000000000000000000000000000000000000000
00000000000000000000000000000000000000000000000000000000000000000000000000000000
00000000000000000000000000000000000000000000000000000000000000000000000000000000
00000000000000000000000003300000000033003300000000000300333330000000000000000000
00000333330133333033330333213330003332332333333333333233232323000000000000000000
00000322223122121122222222211210032222222222221211222211222223000000000000000000
00000312222222222222111222221221222222222222222122222222222223000000000000000000
00000322222222222222222222222222222221222222222221220212222223000000000000000000
00000322222222222112122222222222212222222222122222222222222223000000000000000000
00000312222120222222222222222222222222222222222222222222222213000000000000000000
00000311222222222112222211012211221221112222222222222222222223000000000000000000
00000322122221222222022230003233233331332222222222222222222223000000000000000000
00000312122222022012121330003300330000322222222222222222222223000000000000000000
00000002221222222112220000000000000000322222222222222222222213000000000000000000
00000310022222122112011300000000000000332222222222222222222213000000000000000000
00000322222122222222112300000000000000332222222222222222222223333033000000000000
00000322121222222222212300000000000000322222222222222222222222232332333333330000
00000000221121222222121300000000000000322222222222222222122222222122212221230000
00000000021222222221222300000000000000322222222222222222222222222222212122300000
00000000022211222222211300000000000000322222222222222222222222222122212221000000
00000310002220222222210000000000000000322222222222222222222222222222122211330000
00000321002202222222220000000000000000331222222222222222222222222222222222230000
00000322222201122222222330000000000000322222221222222222222222222222222211330000
00000001222222222221212230033333333330332222222222222222222222222222222222330000
00000000022221221222221300022112122223322222222222222222222222222222222222230000
00000000112212222222212222222222222222222221222222222222222222222222222222330000
00000011222222121122222222222222221221122222222212222222222222222222222212230000
00000322022222222222222221112212222222122121222222222222222222222222222212230000
00000322212221222221212222112002211212222222222222222222222222222222222222330000
00000311102222122222222212222022001212222212222212212222222222222222222222230000
00000000012212200222221020222122112222220122222222222222122222222222211122230000
00000000122222100122221002222222221222212222222122222222222222222222223132330000
00000000322323000032223003232223332322303222232323232223322222222222233003300000
00000000333330000033330003333333003333303333333033333330332222222222223000000000
00000000000000000000000000000000000000000000000000000000032222222222223000000000
00000000000000000000000000000000000000000000000000000000033222222222230000000000
00000000000000000000000000000000000000000000000000000000032222222222223000000000
00000000000000000000000000000000000000000000000000000000032222222222233000000000
00000000000000000000000000000000000000000000000000000000033222222222223000000000
00000000000000000000000000000000000000000000000033333333333222222222223000000000
00000000000000000000000000000000000000000000000032132222222222222222223000000000
00000000000000000000000000000000000000000000033312212222221222222222223000000000
00000000000000000000000000000000000000000000032212122222122222222222223000000000
00000000000000000000000000000000000000000000331222222222222222222222233000000000
00000000000000000000000000000000000000000033322222222222222222222222223000000000
00000000000000000000000000000000000000000332220222222222222222222222223000000000
00000000000000000000000000000000000000003321122222222222222222221222230000000000
00000000000000000000000000000000000000033222222222212222222222221222230000000000
00000000000000000000000000000000000000332222222222222222222222222222233000000000
00000000000000000000000000000000000000322122222222222222222222222222223000000000
00000000000000000000000000000000000033312222222222222222222222222222230000000000
00000000000000000000000000000000000032222222222222222222222222222222230000000000
00000000000000000000000000000000003332222222222222222222222222222222230000000000
00000000000000000000000000000000003222222222222222122222222222222222223000000000
00000000000000000000000000000000003222222222222222222222222222222222233000000000
00000000000000000000000000000000003112222222222222211222222222222222223000000000
00000000000000000000000000000000000012222222222213233333222222222222233000000000
00000000000000000000000000000000003122222222222230300000122222222222223000000000
00000000000000000000000000000000003222112222222330000000322222222222233000000000
00000000000000000000000000000000003222222222221300000000332222222222230000000000
00000000000000000000000000000000003222222222222300000000032222222222230000000000
00000000000000000000000000000000003222222222222300000000032222222222230000000000
00000000000000000000000000000000003122222122222300000000322222222222223000000000
00000000000000000000000000000000003122222222222330000000332222222222223000000000
00000000000000000000000000000000003222211222222230000003332222222222223000000000
00000000000000000000000000000000003122222222222133000003212222222222233000000000
00000000000000000000000000000000003222222222212223333333222222222222213000000000
00000000000000000000000000000000003222222222222222222222222222222222223000000000
00000000000000000000000000000000003222222222222222222222222222222222223000000000
00000000000000000000000000000000003222222222222222222222222222222222223000000000
00000000000000000000000000000000003222222222222222222222222222222222223000000000
00000000000000000000000000000000003111222211222222222211222222122222223000000000
00000000000000000000000000000000000001222222222222222101212211222222233000000000
00000000000000000000000000000000000003232213223322332303232230322222223000000000
00000000000000000000000000000000000003333333333033333303303300333333330000000000
00000000000000000000000000000000000000000000000000000000000000000000000000000000
00000000000000000000000000000000000000000000000000000000000000000000000000000000
00000000000000000000000000000000000000000000000000000000000000000000000000000000
00000000000000000000000000000000000000000000000000000000000000000000000000000000
