00000000000000000000000000000000000000000000000000000000000000000000000000000000
00000000000000000000000000000000000000000000000000000000000000000000000000000000
00000000000000000000000000000000000000000000000000000000000000000000000000000000
00000000000000000000000000000000000000000000000000000000000000000000000000000000
00000000000000000000000000000000000000000000000000000000000000000000000000000000
00000022222222232333333333333333333333333333333333333333333330000000000000000000
00000322222222222222222222222222222222222222222222222222222222000000000000000000
00000322222222222222222222222222222222222222222222222222222222000000000000000000
00000322222222222222222222222222222222222222222222222222222222000000000000000000
00000322222222222222222222222222222222222222222222222222222222000000000000000000
00000322222222222222222222222222222222222222222222222222222222000000000000000000
00000322222221111111111111111111111111111111111111111111122222000000000000000000
00000322222220000000000000000000000000000000000000000000122222000000000000000000
00000322222220000000000000000000000000000000000000000000122222000000000000000000
00000322222220000000000000000000000000000000000000000000122222000000000000000000
00000322222220000000000000000000000000000000000000000000122222000000000000000000
00000322222220000000000000000000000000000000000000000000122222000000000000000000
00000322222220000000000000000000000000000000000000000000122223333333333333000000
00000322222220000000000000000000000000000000000000000000122222222222222222200000
00000322222220000000000000000000000000000000000000000000122212222222222222200000
00000322222220000000000000000000000000000000000000000000122222222222222222200000
00000322222220000000000000000000000000000000000000000000122222222222222222200000
00000322222220000000000000000000000000000000000000000000122222222222222222200000
00000322222220000000000000000000000000000000000000000000011111111111112222200000
00000322222220000000000000000000000000000000000000000000000000000000012222200000
00000322222220000000000000000000000000000000000000000000000000000111112222200000
00000322222221111111111111111111111111111111111111111111111111112222222222200000
00000322222222222222222222222222222222222222222222222222222222222222222222200000
00000322222222222222222222222222222222222222222222222222222222222222222222200000
00000322222222222222222222222222222222222222222222222222222222222222222212200000
00000322222222222222222222222222222222222222222222222222222222222222222212200000
00000322122222222222222222222222222222222222222222222222222222222222211222200000
00000322222222222222222222222222222222222222222222222222222222222222211222300000
00000033333333333333333333333333333333333333333333333333332222222222230333000000
00000000000000000000000000000000000000000000000000000000032222222222230000000000
00000000000000000000000000000000000000000000000000000000032222222222230000000000
00000000000000000000000000000000000000000000000000000000032222222222230000000000
00000000000000000000000000000000000000000000000000000000032222222222230000000000
00000000000000000000000000000000000000000000000000000000032222222222230000000000
00000000000000000000000000000000000000000000000000000000032222222222230000000000
00000000000000000000000000000000000000000000000033333333332222222222230000000000
00000000000000000000000000000000000000000000000322222222222222222222230000000000
00000000000000000000000000000000000000000000003322222222222222222222230000000000
00000000000000000000000000000000000000000000032222222222222222222222230000000000
00000000000000000000000000000000000000000000032222222222222222222222230000000000
00000000000000000000000000000000000000000002222222222222222222222222230000000000
00000000000000000000000000000000000000000003222222222222222222222222230000000000
00000000000000000000000000000000000000000332222222222222222222222222230000000000
00000000000000000000000000000000000000003222222222222222111111122222230000000000
00000000000000000000000000000000000000003222222222222222100000122222230000000000
00000000000000000000000000000000000000222222222222222222100000122222230000000000
00000000000000000000000000000000000003322222222222222200000000122222230000000000
00000000000000000000000000000000000032222222222222222200000000122222230000000000
00000000000000000000000000000000000032222222222222211000000000122222230000000000
00000000000000000000000000000000000022222222222222210000000000122222230000000000
00000000000000000000000000000000000022222222222222200000000000122222230000000000
00000000000000000000000000000000000022222222222221000000000000122222230000000000
00000000000000000000000000000000000022222222222221000000000000122222230000000000
00000000000000000000000000000000000022222222222210000000000000122222230000000000
00000000000000000000000000000000000022222222222200000000000000122222230000000000
00000000000000000000000000000000000022222222122200000000000000122222230000000000
00000000000000000000000000000000000022222222122200000000000000122222230000000000
00000000000000000000000000000000000022222222122200000000000000122222230000000000
00000000000000000000000000000000000022222222122200000000000000122222230000000000
00000000000000000000000000000000000022222222122200000000000000122222230000000000
00000000000000000000000000000000000022222222122333000000000000122222230000000000
00000000000000000000000000000000000022222222222222300000000000122222230000000000
00000000000000000000000000000000000022222222222222333331111111122222230000000000
00000000000000000000000000000000000022222222222222222222222222222222230000000000
00000000000000000000000000000000000022222122222222222222222222222222230000000000
00000000000000000000000000000000000022222222222222222222222222222222230000000000
00000000000000000000000000000000000022222222222222222222222222222222230000000000
00000000000000000000000000000000000022222222222222222222222222222222230000000000
00000000000000000000000000000000000022222222222222222222222222222222230000000000
00000000000000000000000000000000000003222222222222222222222222222222200000000000
00000000000000000000000000000000000000000000000000000000000000000000000000000000
00000000000000000000000000000000000000000000000000000000000000000000000000000000
00000000000000000000000000000000000000000000000000000000000000000000000000000000
00000000000000000000000000000000000000000000000000000000000000000000000000000000
00000000000000000000000000000000000000000000000000000000000000000000000000000000
