11111111111111111111111111111111111111111111111111111111111111111111111111111111
11111111111111111111111111111111111111111111111111111111111111111111111111111111
11111111111111111111111111111111111111111111111111111111111111111111111111111111
11111111111111111111111111111111111111111111111111111111111111111111111111111111
11111111111111111111111111111111111111111111111111111111111111111111111111111111
11111100000000000000001111111111111111111111111111111111111111111111111111111111
11111000000000000000000000000000000000000000000000000000000000111111111111111111
11111000000000000000000000000000000000000000000000000000000000111111111111111111
11111000000000000000000000000000000000000000000000000000000000111111111111111111
11111000000000000000000000000000000000000000000000000000000000111111111111111111
11111000000000000000000000000000000000000000000000000000000000111111111111111111
11111000000000000000000000000000000000000000000000000000000000111111111111111111
11111000000000000000000010000000000000000000000000000010000000111111111111111111
11111000000000000000000011111111111111100001000000000010000000111111111111111111
11111000000001111111100011111111111111100011000000000010000000111111111111111111
11111000000001111111100011111111111111100000001111000010000000111111111111111111
11111000000001111111100011111111111111100000001111000010000000111111111111111111
11111000000001111111100011111111111111100000001000000010000000111111111111111111
11111000000001111111100011111111111111100000001000000010000000000000000000011111
11111000000001111111100011111111111111100000000000000010000000000000000000011111
11111000000001111111100011111111111111100000000000000010000000000000000000011111
11111000000001111111100011111111111111100000100000000010000000000000000000011111
11111000000001111111100011111111111111100000100000000010000000000000000000011111
11111000000001111111100011111111111111100000100000000000000000000000000000011111
11111000000001111111100000000000000000000000100000000000111110000000000000011111
11111000000001111111100000000000000000000000100000000000111110000000000000011111
11111000000001111111100000000000000000000000000000000000000000000000000000011111
11111000000000000000000000000000000000000000000000000000000000001111100000011111
11111000000000000000000000000000000000000000000000000000000000000000000000011111
11111000000000000000000000000000000000000000000000000000000000000000000000011111
11111000000000000000000000000000000000000000000000000000000000000000000000011111
11111000000000000000000000000000000000000000000000000000000000000000000000011111
11111000000000000000000000000000000000000000000000000000000000000000000000011111
11111100000000000000000000000000000000000000000000000000000000000000000000011111
11111111111111111111111111111111111111111111111111111111100000000000001111111111
11111111111111111111111111111111111111111111111111111111100000000000001111111111
11111111111111111111111111111111111111111111111111111111100000000000001111111111
11111111111111111111111111111111111111111111111111111111100000000000001111111111
11111111111111111111111111111111111111111111111111111111100000000000001111111111
11111111111111111111111111111111111111111111111111111111100000000000001111111111
11111111111111111111111111111111111111111111111100000000000000000000001111111111
11111111111111111111111111111111111111111111111100000000000000000000001111111111
11111111111111111111111111111111111111111111111100000000000000000000001111111111
11111111111111111111111111111111111111111111111100000000000000000000001111111111
11111111111111111111111111111111111111111111111100000000000000000000001111111111
11111111111111111111111111111111111111111111111100000000000000000000001111111111
11111111111111111111111111111111111111111111111100000000000000000000001111111111
11111111111111111111111111111111111111111111111100000000000000000000001111111111
11111111111111111111111111111111111111111111111100000000000000000000001111111111
11111111111111111111111111111111111111111111111100000000000000000000001111111111
11111111111111111111111111111111111111100000000000000000000000000000001111111111
11111111111111111111111111111111111111100000000000000000000000000000001111111111
11111111111111111111111111111111111111100000000000000000000000000000001111111111
11111111111111111111111111111111111000000000000000000000000000000000001111111111
11111111111111111111111111111111111000000000000000000000000000000000001111111111
11111111111111111111111111111111111000000000000000000000000000000000001111111111
11111111111111111111111111111111111000000000000000000000000000000000001111111111
11111111111111111111111111111111111000000000000000000000000000000000001111111111
11111111111111111111111111111111111000000000001011111110000000000000001111111111
11111111111111111111111111111111111000000000000011111111000000000000001111111111
11111111111111111111111111111111111000000000000011111111100000000000001111111111
11111111111111111111111111111111111000000000000011111111100000000000001111111111
11111111111111111111111111111111111000000000000011111111100000000000001111111111
11111111111111111111111111111111111000000000000011111111100000000000001111111111
11111111111111111111111111111111111000000000110011111111100000000000001111111111
11111111111111111111111111111111111000000000110001111111000000000000001111111111
11111111111111111111111111111111111000000000000001111111100000000000001111111111
11111111111111111111111111111111111000000000000000000000000000000000001111111111
11111111111111111111111111111111111000000000000000000000000000000000001111111111
11111111111111111111111111111111111000000000000000000000000000000000001111111111
11111111111111111111111111111111111000000000000000000000000000000000001111111111
11111111111111111111111111111111111000000000000000000000000000000000001111111111
11111111111111111111111111111111111000000000000000000000000000000000001111111111
11111111111111111111111111111111111000000000000000000000000000000000001111111111
11111111111111111111111111111111111000000000000000000000000000000000001111111111
11111111111111111111111111111111111111111111111111111111111111111111111111111111
11111111111111111111111111111111111111111111111111111111111111111111111111111111
11111111111111111111111111111111111111111111111111111111111111111111111111111111
11111111111111111111111111111111111111111111111111111111111111111111111111111111
11111111111111111111111111111111111111111111111111111111111111111111111111111111
