00000000000000000000000000000000000000000000000000000000000000000000000000000002
00000000000000000000000000000000000000000000000000000000000000000000000000000000
00000000000000000000000000000000000000000000000000000000000000000000000000000000
00000000000000000000000000000000000000000000000000000000000000000000000000000000
00000000000000000330000000000000000000000000000000000000003000000000000000000000
00000000000033333230000033330003330000000033300000000000032300000000000000000000
00000311000112121220000012221112210000000012100000000000012100000000000000000000
00000321000120221220000120002221122000000001220000000000022113000000000000000000
00000322221020222120001200002212222110000000221111111111222223000000000000000000
00000302112220222120012002221011112222111111222222222222222023000000000000000000
00000002012112222121112221111122222222222222022100000002012213000000000000000000
00000311212111122222222222222200000012200222112200000002102200000000000000000000
00000322222222222122221333333000000000322222222221100021221200000000000000000000
00000312222000022122122300000000000000331111222222222222222213000000000000000000
00000001212222222222221300000000000000000000111122222212111223000000000000000000
00000012202111222220000000000000000000000000000021202122211213000000000000000000
00000012002112222222222300000000000000000000000021222210122223300000000033300000
00000320001222222221122300000000000000000000000002122111021222300033300332330000
00000322222222121221201300000000000000000000000002222012201211000012100122230000
00000312222221222222111300000000000000000000000001211202001220000012211122300000
00000321111022222222222300000000000000000000000002211220002120000012222222100000
00000311000022121222122300000000000000000000000021121202021120000012212122000000
00000000000220221222210000000000000000000000002221102112201120000122021212300000
00000000001222221222220000000000000000000000002211222111210120012212221222230000
00000000112200021220021000333003333333300000221210222222222222222222222122330000
00000011222100022220021033323332222222222222222222211221121122211112122222000000
00000302222222222222222222222221111122111112121121100201012220000022222120000000
00000322222111212122112112112210000022000021121200000221122220000222212121330000
00000312221122002122002221001200000212000210212000022122201221112222222222230000
00000302021020000222002210000120022222222222222222222222222222222222222221330000
00000322222222222222222222222222212121121112211112212222222112221121000121000000
00000311221111111122211121111112121122222222222122220000211122210221000121000000
00000012210000000122110021222222222222101121000122100000122212200220000323000000
00000032300000000122300032333333233323003230000323300000322022122120000333000000
00000033300000000033000033000000330033003330000333000000333222022120000000000000
00000000000000000000000000000000000000000000000000000000032112211221133000000000
00000000000000000000000000000000000000000000000000000000033222222222223000000000
00000000000000000000000000000000000000000000000000000000033122221222233000000000
00000000000000000000000000000000000000000000000000000000032202200122100000000000
00000000000000000000000000000000000000000000000000000000003022202222030000000000
00000000000000000000000000000000000000000000000333000033330222222221233000000000
00000000000000000000000000000000000000000000000322110032210211222120223000000000
00000000000000000000000000000000000000000000000112201022222022211222130000000000
00000000000000000000000000000000000000000000000011222222222222222222110000000000
00000000000000000000000000000000000000000000000001222221222222211211223000000000
00000000000000000000000000000000000000000000000000221221222222222222233000000000
00000000000000000000000000000000000000000001111112122222222201201200000000000000
00000000000000000000000000000000000000003332222222222222222210121200000000000000
00000000000000000000000000000000000000033220002211222222212221121200000000000000
00000000000000000000000000000000000000032121012222222221222222121200000000000000
00000000000000000000000000000000000000031222222012222210102212221200000000000000
00000000000000000000000000000000000033111112222122222121011222122210000000000000
00000000000000000000000000000000000032222221222222212121101220221211000000000000
00000000000000000000000000000000000331222222222222221112111222221222130000000000
00000000000000000000000000000000003222220100222222222222222222221211223000000000
00000000000000000000000000000000003220221002212112210022211122222222223000000000
00000000000000000000000000000000000112212021222222100001222021222000233000000000
00000000000000000000000000000000003221222211221223300000221222212222230000000000
00000000000000000000000000000000003221022222100233000000122002222221230000000000
00000000000000000000000000000000003302211222002030000000332102122222230000000000
00000000000000000000000000000000000022211222222300000000032200222122223000000000
00000000000000000000000000000000003211022212122300000000031220212222133000000000
00000000000000000000000000000000003222212222223300000000000221212212100000000000
00000000000000000000000000000000003112122202222300000000331121022222000000000000
00000000000000000000000000000000003222220002222300000000321122022221230000000000
00000000000000000000000000000000003211221112112330000000312222122121223000000000
00000000000000000000000000000000003012002120102230000000001212222222233000000000
00000000000000000000000000000000000102012221021100003331000022212222133000000000
00000000000000000000000000000000000321120020121000012222211112222212223000000000
00000000000000000000000000000000003220200212021001120000222022122222130000000000
00000000000000000000000000000000003222222220221010220001122222222211200000000000
00000000000000000000000000000000003211112112222222220112200021122222230000000000
00000000000000000000000000000000003220020101122211112222222222222222223000000000
00000000000000000000000000000000000102221000122221221111112222222222223000000000
00000000000000000000000000000000000013231000321032030000032330323223333000000000
00000000000000000000000000000000000000330000330033300000033300033333000000000000
00000000000000000000000000000000000000000000000000000000000000000000000000000000
00000000000000000000000000000000000000000000000000000000000000000000000000000000
00000000000000000000000000000000000000000000000000000000000000000000000000000000
00000000000000000000000000000000000000000000000000000000000000000000000000000000
