0000000000000000000000000000000000000000
0000000000000000000000000000000000000000
0000000000000000000000000000000000000000
0000000000000000000000000000000000000000
0002222222222222222222222222210000000000
0003222222222222222222222222110000000000
0003322222100000000222222221110000000000
0003332221100000000342222211110000000000
0003333211100000000033222111110000000000
0003333311100000000033321111110000000000
0003333311100000000033331111122222221000
0003333311100000000033331111222222211000
0003333311100000000033344112222222111000
0003333441222222222233444422221144411000
0003334444444444444444444444444114441000
0003344444444444444444444444444111444000
0003444444444444444444444444443111000000
0000000000000000000000000000033111000000
0000000000000000000000000000033111000000
0000000000000000000000000000033111000000
0000000000000000000000000010033111000000
0000000000000000000000002232233111000000
0000000000000000000000003223223111000000
0000000000000000000000223322322111000000
0000000000000000000000322332231111000000
0000000000000000000022332233221111000000
0000000000000000000032233223341111000000
0000000000000000002233223344444111000000
0000000000000000003223314444443111000000
0000000000000000003322340000033111000000
0000000000000000003332100000033111000000
0000000000000000003333100000033111000000
0000000000000000003333100000033111000000
0000000000000000003333210000033111000000
0000000000000000003334444402234411000000
0000000000000000003344444444444441000000
0000000000000000003444444444444444000000
0000000000000000000000000000000000000000
0000000000000000000000000000000000000000
0000000000000000000000000000000000000000
