00000000000000000000000000000000000000000000000000000000000000000000000000000000
00000000000000000000000000000000000000000000000000000000000000000000000000000000
00000000000000000000000000000000000000000000000000000000000000000000000000000000
00000000000000000000000000000000000000000000000000000000000000000000000000000000
00000000000000000000000000000000000000000000000000000000000000000000000000000000
00000033333333330333333333333333333333333333333333333333333330000000000000000000
00000322222222221222222222222222222222222222222222222222222223000000000000000000
00000322222222222222222222222222222222222222222222222222222223000000000000000000
00000322122222222221111111111111111111111111111111111111111223000000000000000000
00000322121111111112222222222222222222222222222222222222222223000000000000000000
00000322122222222222111111111111111111111111111111111111112223000000000000000000
00000322122111111111000000000000000000000000000000000000012223000000000000000000
00000322122100000000000000000000000000000000000000000000012223000000000000000000
00000322122100000000000000000000000000000000000000000000012223000000000000000000
00000322122100000000000000000000000000000000000000000000012223000000000000000000
00000322122100000000000000000000000000000000000000000000012223000000000000000000
00000322122100000000000000000000000000000000000000000000012223000000000000000000
00000322122100000000000000000000000000000000000000000000012223333333333333300000
00000322122100000000000000000000000000000000000000000000012222222222222222230000
00000322122100000000000000000000000000000000000000000000012222222222222221230000
00000322122100000000000000000000000000000000000000000000012111111111111121230000
00000322122100000000000000000000000000000000000000000000012222222222222221230000
00000322122100000000000000000000000000000000000000000000001111111111111221230000
00000322122100000000000000000000000000000000000000000000000000000000001221230000
00000322122100000000000000000000000000000000000000000000000000000000001221230000
00000322122100000000000000000000000000000000000000000000000000000000001221230000
00000322122100000000000000000000000000000000000000000000000000000000001221230000
00000322122111111111111111111111111111111111111111111111111111000000001221230000
00000322122222222222222222222222222222222222222222222222222222100000001221230000
00000322122222222222222222222222222222222222222222222222222222100111111221230000
00000322111111111111111111111111111111111111111111111111111122101222222221230000
00000322222222222222222222222222222222222222222222222222222222101212222221230000
00000322222222222222222222222222222222222222222222222222222222101212222222230000
00000033333333333333333333333333333333333333333333333333332222101212233333300000
00000000000000000000000000000000000000000000000000000000032222101212230000000000
00000000000000000000000000000000000000000000000000000000032222101212230000000000
00000000000000000000000000000000000000000000000000000000032222101212230000000000
00000000000000000000000000000000000000000000000000000000032222101212230000000000
00000000000000000000000000000000000000000000000000000000032222101212230000000000
00000000000000000000000000000000000000000000000000000000032222101212230000000000
00000000000000000000000000000000000000000000000033333333332222101212230000000000
00000000000000000000000000000000000000000000000322222222222222101212230000000000
00000000000000000000000000000000000000000000003221222222222222101212230000000000
00000000000000000000000000000000000000000000032212222222222222101212230000000000
00000000000000000000000000000000000000000000322222222222222222101212230000000000
00000000000000000000000000000000000000000000322212222111111111001212230000000000
00000000000000000000000000000000000000000033222222221000000000001212230000000000
00000000000000000000000000000000000000000322221211210000000000001212230000000000
00000000000000000000000000000000000000003221222212210000000000001212230000000000
00000000000000000000000000000000000000032212222222100000000000001212230000000000
00000000000000000000000000000000000000322222222211000000000000001212230000000000
00000000000000000000000000000000000000322222221100000000000000001212230000000000
00000000000000000000000000000000000033222222221000000000000000001212230000000000
00000000000000000000000000000000000322222211110000000000000000001212230000000000
00000000000000000000000000000000003221222210000000000000000000001212230000000000
00000000000000000000000000000000003212222100000000000000000000001212230000000000
00000000000000000000000000000000003212221000000000000000000000001212230000000000
00000000000000000000000000000000003212210000000000000000000000001212230000000000
00000000000000000000000000000000003212210000000000000000000000001212230000000000
00000000000000000000000000000000003212210000000000000000000000001212230000000000
00000000000000000000000000000000003212210000000000000000000000001212230000000000
00000000000000000000000000000000003212210000000000000000000000001212230000000000
00000000000000000000000000000000003212210000000000000000000000001212230000000000
00000000000000000000000000000000003212210000000000000000000000001212230000000000
00000000000000000000000000000000003212210000000000000000000000001212230000000000
00000000000000000000000000000000003212210000000000000000000000001212230000000000
00000000000000000000000000000000003212210000000000000000000000001212230000000000
00000000000000000000000000000000003212210000000000000000000000001212230000000000
00000000000000000000000000000000003212210000000000000000000000001212230000000000
00000000000000000000000000000000003212210000000000000000000000001212230000000000
00000000000000000000000000000000003212211111111111111111111111111212230000000000
00000000000000000000000000000000003212222222222222222222222222222212230000000000
00000000000000000000000000000000003212222222222222222222222222222222230000000000
00000000000000000000000000000000003211111111111111111111111111111111230000000000
00000000000000000000000000000000003222222222222222222222222222222222230000000000
00000000000000000000000000000000000333333333333333333333333333333333300000000000
00000000000000000000000000000000000000000000000000000000000000000000000000000000
00000000000000000000000000000000000000000000000000000000000000000000000000000000
00000000000000000000000000000000000000000000000000000000000000000000000000000000
00000000000000000000000000000000000000000000000000000000000000000000000000000000
