0000000000000000000000000000000000000000
0000000000000000000000000000000000000000
0000000000000000000000200000000000000000
0002222222222222222223111444444444444400
0032222222222222222222111144444444444300
0033222222222222222221111114444444443300
0033422222222222222311111111444444433300
0033332222222222223111111111144444333300
0033333222222222301111111111114443333300
0033333000000000001111111111111433333300
0033333400000000001111111111111333333300
0033333300000000001111111111122333333300
0033333300000000001111111111222233333300
0033333300000000001111111112222223333300
0033333300000000001111111122222222333300
0033333300000000001111111222222222233300
0033333300000000001111112222222222223300
0033333300000000001111122222222222222300
0033333300000000001111222222222222222310
0033333300000000001112222222222222222110
0033333300000000001122222222222222231110
0033333300000000001222222222222222311110
0033333300000000002222222222222230111110
0033333000000000000000000000000000111110
0033333000000000000000000000000000111110
0033333000000000000000000000000000111110
0033333000000000000000000000000000111110
0033333000000000000000000000000000111110
0033333000000000000000000000000000111110
0033333000000000000000000000000000211110
0033333000000000000000000000000000011110
0033333144444444444444444444444444411110
0033334444444444444444444444444444442210
0033331444444444444444444444444444444410
0033144444444444444444444444444444444410
0004444444444444444444444444444444444440
0000000000000000000000000000000000000000
0000000000000000000000000000000000000000
0000000000000000000000000000000000000000
0000000000000000000000000000000000000000
