00000000000000000000000000000000000000000000000000000000000000000000000000000000
00000000000000000000000000000000000000000000000000000000000000000000000000000000
00000000000000000000000000000000000000000000000000000000000000000000000000000000
00000000000000000000000000000000000000000000000000000000000000000000000000000000
00000000000000000000000000000000000000000000000000000000000000000000000000000000
00000022222222222222220000000000000000000000000000000000000000000000000000000000
00000222222222222222222222222222222222222222222222222222222222000000000000000000
00000222222222222222222222222222222222222222222222222222222222000000000000000000
00000222222222222222222222222222222222222222222222222222222222000000000000000000
00000222222222222222222222222222222222222222222222222222222222000000000000000000
00000222222222222222222222222222222222222222222222222222222222000000000000000000
00000222222222222222222222222222222222222222222222222222222222000000000000000000
00000222222222222222222202222222222222222222222222222202222222000000000000000000
00000222222222222222222200000000000000022222222222222202222222000000000000000000
00000222222220000000022200000000000000022222222222222202222222000000000000000000
00000222222220000000022200000000000000022222220000222202222222000000000000000000
00000222222220000000022200000000000000022222220000222202222222000000000000000000
00000222222220000000022200000000000000022222220222222202222222000000000000000000
00000222222220000000022200000000000000022222220222222202222222222222222222200000
00000222222220000000022200000000000000022222222222222202222222222222222222200000
00000222222220000000022200000000000000022222222222222202222222222222222222200000
00000222222220000000022200000000000000022222022222222202222222222222222222200000
00000222222220000000022200000000000000022222022222222202222222222222222222200000
00000222222220000000022200000000000000022222022222222222222222222222222222200000
00000222222220000000022222222222222222222222022222222222000002222222222222200000
00000222222220000000022222222222222222222222022222222222000002222222222222200000
00000222222220000000022222222222222222222222222222222222222222222222222222200000
00000222222222222222222222222222222222222222222222222222222222220000022222200000
00000222222222222222222222222222222222222222222222222222222222222222222222200000
00000222222222222222222222222222222222222222222222222222222222222222222222200000
00000222222222222222222222222222222222222222222222222222222222222222222222200000
00000222222222222222222222222222222222222222222222222222222222222222222222200000
00000222222222222222222222222222222222222222222222222222222222222222222222200000
00000022222222222222222222222222222222222222222222222222222222222222222222200000
00000000000000000000000000000000000000000000000000000000022222222222220000000000
00000000000000000000000000000000000000000000000000000000022222222222220000000000
00000000000000000000000000000000000000000000000000000000022222222222220000000000
00000000000000000000000000000000000000000000000000000000022222222222220000000000
00000000000000000000000000000000000000000000000000000000022222222222220000000000
00000000000000000000000000000000000000000000000000000000022222222222220000000000
00000000000000000000000000000000000000000000000022222222222222222222220000000000
00000000000000000000000000000000000000000000000022222222222222222222220000000000
00000000000000000000000000000000000000000000000022222222222222222222220000000000
00000000000000000000000000000000000000000000000022222222222222222222220000000000
00000000000000000000000000000000000000000000000022222222222222222222220000000000
00000000000000000000000000000000000000000000000022222222222222222222220000000000
00000000000000000000000000000000000000000000000022222222222222222222220000000000
00000000000000000000000000000000000000000000000022222222222222222222220000000000
00000000000000000000000000000000000000000000000022222222222222222222220000000000
00000000000000000000000000000000000000000000000022222222222222222222220000000000
00000000000000000000000000000000000000022222222222222222222222222222220000000000
00000000000000000000000000000000000000022222222222222222222222222222220000000000
00000000000000000000000000000000000000022222222222222222222222222222220000000000
00000000000000000000000000000000000222222222222222222222222222222222220000000000
00000000000000000000000000000000000222222222222222222222222222222222220000000000
00000000000000000000000000000000000222222222222222222222222222222222220000000000
00000000000000000000000000000000000222222222222222222222222222222222220000000000
00000000000000000000000000000000000222222222222222222222222222222222220000000000
00000000000000000000000000000000000222222222220200000002222222222222220000000000
00000000000000000000000000000000000222222222222200000000222222222222220000000000
00000000000000000000000000000000000222222222222200000000022222222222220000000000
00000000000000000000000000000000000222222222222200000000022222222222220000000000
00000000000000000000000000000000000222222222222200000000022222222222220000000000
00000000000000000000000000000000000222222222222200000000022222222222220000000000
00000000000000000000000000000000000222222222002200000000022222222222220000000000
00000000000000000000000000000000000222222222002220000000222222222222220000000000
00000000000000000000000000000000000222222222222220000000022222222222220000000000
00000000000000000000000000000000000222222222222222222222222222222222220000000000
00000000000000000000000000000000000222222222222222222222222222222222220000000000
00000000000000000000000000000000000222222222222222222222222222222222220000000000
00000000000000000000000000000000000222222222222222222222222222222222220000000000
00000000000000000000000000000000000222222222222222222222222222222222220000000000
00000000000000000000000000000000000222222222222222222222222222222222220000000000
00000000000000000000000000000000000222222222222222222222222222222222220000000000
00000000000000000000000000000000000222222222222222222222222222222222220000000000
00000000000000000000000000000000000000000000000000000000000000000000000000000000
00000000000000000000000000000000000000000000000000000000000000000000000000000000
00000000000000000000000000000000000000000000000000000000000000000000000000000000
00000000000000000000000000000000000000000000000000000000000000000000000000000000
00000000000000000000000000000000000000000000000000000000000000000000000000000000
