00000000000000000000000000000000000000000000000000000000000000000000000000000001
00000000000000000000000000000000000000000000000000000000000000000000000000000000
00000000000000000000000000000000000000000000000000000000000000000000000000000000
00000000000000000000000000000000000000000000000000000000000000000000000000000000
00000000000000000000000000000000000000000000000000000000000000000000000000000000
00000000000000033333333333333333333330000000000000000000000000000000000000000000
00000000000000122222222222222222222221000000000000000000000000000000000000000000
00000000000000122212222222212222222221000000000000000000000000000000000000000000
00000000000000122212222222212222222221000000000000000000000000000000000000000000
00000000000000122212222222212222222221000000000000000000000000000000000000000000
00000000000000122212222222212222222221000000000000000000000000000000000000000000
00000000000000122212222222212222222221000000000000000000000000000000000000000000
00000000000000122212222333303333333330000000000000000000000000000000000000000000
00000000000000122212222300000000000000000000000000000000000000000000000000000000
00000000000000122212222300000000000000000000000000000000000000000000000000000000
00000000000000122212222300000000000000000000000000000000000000000000000000000000
00000000000000122212222300000000000000000000000000000000000000000000000000000000
00000000000000122212222300000000000000000000000000000000000000000000000000000000
00000000000000122212222300000000000000000000000000000000000000000000000000000000
00000000000000122212222300000000000000000000000000000000000000000000000000000000
00000000000000122212222300000000000000000000000000000000000000000000000000000000
00000000000000122212222300000000000000000000000000000000000000000000000000000000
00000000000000122212222300000000000000000000000000000000000000000000000000000000
00000000000000122212222300000000000000000000000000000000000000000000000000000000
00000000000000122212222300000000000000000000000000000000000000000000000000000000
00000000000000012212222100000000000000000000000000000000000000000000000000000000
00000000000000012212222100000000000000000000000000000000000000000000000000000000
00000000000000012212222100000000000000000000000000000000000000000000000000000000
00000000000000012212222100000000000000000000000000000000000000000000000000000000
00000000000000012212222100000000000000000000000000000000000000000000000000000000
00000000000000012212222100000000000000000000000000000000000000000000000000000000
00000000000000012212222100000000000000000000000000000000000000000000000000000000
00000000000000012212222100000000000000000000000000000000000000000000000000000000
00000000000000012212222100000000000000000000000000000000000000000000000000000000
00000000000000003303333000000000000000000000000000000000000000000000000000000000
00000000000000000000000000000000000000000000000000000000000000000000000000000000
00000000000000000000000000000000000000000000000000000000000000000000000000000000
00000000000000000000000000000000000000000000000000000000000000000000000000000000
00000000000000000000000000000000000000000000000000000000000000000000000000000000
00000000000000000000000000000000000000000000000000000000000000000000000000000000
00000000000000000000000000000000000000000000000000000000000000000000000000000000
00000000000000000000000000000000000000000000000000000000000000000000000000000000
00000000000000000000000000000000000000000000000000000000000000000000000000000000
00000000000000000000000000000000000000000000000000000000000000000000000000000000
00000000000000000000000000000000000000000000000000000000000000000000000000000000
00000000000000000000000000000000000000000000000000000000000000000000000000000000
00000000000000000000000000000000000000000000000000000000000000000000000000000000
00000000000000000000000000000000000000000000000000000000000000000000000000000000
00000000000000000000000000000000000000000000000000000000000000000000000000000000
00000000000000000000000000000000000000000000000000000000000000000000000000000000
00000000000000000000000000000000000000000000000000000000000000000000000000000000
00000000000000000000000000000000000000000000000000000000000000000000000000000000
00000000000000000000000000000000000000000000000000000000000000000000000000000000
00000000000000000000000000000000000000000000000000000000000000000000000000000000
00000000000000000000000000000000000000000000000000000000000000000000000000000000
00000000000000000000000000000000000000000000000000000000000000000000000000000000
00000000000000000000000000000000000000000000000000000000000000000000000000000000
00000000000000000000000000000000000000000000000000000000000000000000000000000000
00000000000000000000000000000000000000000000000000000000000000000000000000000000
00000000000000000000000000000000000000000000000000000000000000000000000000000000
00000000000000000000000000000000000000000000000000000000000000000000000000000000
00000000000000000000000000000000000000000000000000000000000000000000000000000000
00000000000000000000000000000000000000000000000000000000000000000000000000000000
00000000000000000000000000000000000000000000000000000000000000000000000000000000
00000000000000000000000000000000000000000000000000000000000000000000000000000000
00000000000000000000000000000000000000000000000000000000000000000000000000000000
00000000000000000000000000000000000000000000000000000000000000000000000000000000
00000000000000000000000000000000000000000000000000000000000000000000000000000000
00000000000000000000000000000000000000000000000000000000000000000000000000000000
00000000000000000000000000000000000000000000000000000000000000000000000000000000
00000000000000000000000000000000000000000000000000000000000000000000000000000000
00000000000000000000000000000000000000000000000000000000000000000000000000000000
00000000000000000000000000000000000000000000000000000000000000000000000000000000
00000000000000000000000000000000000000000000000000000000000000000000000000000000
00000000000000000000000000000000000000000000000000000000000000000000000000000000
00000000000000000000000000000000000000000000000000000000000000000000000000000000
00000000000000000000000000000000000000000000000000000000000000000000000000000000
00000000000000000000000000000000000000000000000000000000000000000000000000000000
00000000000000000000000000000000000000000000000000000000000000000000000000000000
00000000000000000000000000000000000000000000000000000000000000000000000000000000
