00000000000000000000000000000000000000000000000000000000000000000000000000000001
00000000000000000000000000000000000000000000000000000000000000000000000000000000
00000000000000000000000000000000000000000000000000000000000000000000000000000000
00000000000000000000000000000000000000000000000000000000000000000000000000000000
00000000000000000000000000000000000000000000000000000000000000000000000000000000
00000000000000000000000000000000000000000000000000000000000000000000000000000000
00000000000000000000000000000000000000000000000000000000000000000000000000000000
00000000000000000000000000000000000000000000000000000000000000000000000000000000
00000000000000000000000000000000000000000000000000000000000000000000000000000000
00000000000000000000000000000000000000000000000000000000000000000000000000000000
00000000000000000000000000000000000000000000000000000000000000000000000000000000
00000000000000000000000000000000000000000000000000000000000000000000000000000000
00000000000000000000000000000000000000000000000000000000000012300000000000000000
00000000000000000000000000000000000000000000000000000000000012300000000000000000
00000000000000000000000000000000000000000000000000000000000012300000000000000000
00000000000000000000000000000000000000000000000000000000000012300000000000000000
00000000000000000000000000000000000000000000000000000000000012300000000000000000
00000000000000000000000000000000000000000000000000000000000012300000000000000000
00000000000000000000000000000000000000000000000000000000000012333333333333300000
00000000000000000000000000000000000000000000000000000000000012222222222222230000
00000000000000000000000000000000000000000000000000000000000012222222222222230000
00000000000000000000000000000000000000000000000000000000000012222222222222230000
00000000000000000000000000000000000000000000000000000000000012222222222222230000
00000000000000000000000000000000000000000000000000000000000012222222222222230000
00000000000000000000000000000000000000000000000000000000000012222222222222230000
00000000000000000000000000000000000000000000000000000000000012222222222222230000
00000000000000000000000000000000000000000000000000000000000012222222222222230000
00000000000000000000000000000000000000000000000000000000000012222222222222230000
00000000000000000000000000000000000000000000000000000000000012222222222222230000
00000000000000000000000000000000000000000000000000000000000012222222222222230000
00000000000000000000000000000000000000000000000000000000000012222222222222230000
00000000000000000000000000000000000000000000000000000000000012222222222222330000
00000000000000000000000000000000000000000000000000000000000012222222222333300000
00000000000000000000000000000000000000000000000000000000000012222222233000000000
00000000000000000000000000000000000000000000000000000000000012222222230000000000
00000000000000000000000000000000000000000000000000000000000012222222230000000000
00000000000000000000000000000000000000000000000000000000000012222222230000000000
00000000000000000000000000000000000000000000000000000000000012222222230000000000
00000000000000000000000000000000000000000000000000000000000012222222230000000000
00000000000000000000000000000000000000000000000000000000000012222222230000000000
00000000000000000000000000000000000000000000000000000000000012222222230000000000
00000000000000000000000000000000000000000000000000000000000012222222230000000000
00000000000000000000000000000000000000000000000000000000000012222222230000000000
00000000000000000000000000000000000000000000000000000000000012222222230000000000
00000000000000000000000000000000000000000000000000000000000012222222230000000000
00000000000000000000000000000000000000000000000000000000000012222222230000000000
00000000000000000000000000000000000000000000000000000000000012222222230000000000
00000000000000000000000000000000000000000000000000000000000012222222230000000000
00000000000000000000000000000000000000000000000000000000000012222222230000000000
00000000000000000000000000000000000000000000000000000000000012222222230000000000
00000000000000000000000000000000000000000000000000000000000012222222230000000000
00000000000000000000000000000000000000000000000000000000000012222222230000000000
00000000000000000000000000000000000000000000000000000000000012222222230000000000
00000000000000000000000000000000000000000000000000000000000012222222230000000000
00000000000000000000000000000000000000000000000000000000000012222222230000000000
00000000000000000000000000000000000000000000000000000000000012222222230000000000
00000000000000000000000000000000000000000000000000000000000012222222230000000000
00000000000000000000000000000000000000000000000000000000000012222222230000000000
00000000000000000000000000000000000000000000000000000000000012222222230000000000
00000000000000000000000000000000000000000000000000000000000012222222230000000000
00000000000000000000000000000000000000000000000000000000000012222222230000000000
00000000000000000000000000000000000000000000000000000000000012222222230000000000
00000000000000000000000000000000000000000000000000000000000012222222230000000000
00000000000000000000000000000000000000000000000000000000000012222222230000000000
00000000000000000000000000000000000000000000000000000000000012222222230000000000
00000000000000000000000000000000000000000000000000000000000012222222230000000000
00000000000000000000000000000000000000000000000000000000000012222222230000000000
00000000000000000000000000000000000000000000000000000000000012222222230000000000
00000000000000000000000000000000000000000000000000000000000012222222230000000000
00000000000000000000000000000000000000000000000000000000000012222222230000000000
00000000000000000000000000000000000000000000000000000000000012222222230000000000
00000000000000000000000000000000000000000000000000000000000012222222230000000000
00000000000000000000000000000000000000000000000000000000000012222222230000000000
00000000000000000000000000000000000000000000000000000000000012222222230000000000
00000000000000000000000000000000000000000000000000000000000003333333300000000000
00000000000000000000000000000000000000000000000000000000000000000000000000000000
00000000000000000000000000000000000000000000000000000000000000000000000000000000
00000000000000000000000000000000000000000000000000000000000000000000000000000000
00000000000000000000000000000000000000000000000000000000000000000000000000000000
00000000000000000000000000000000000000000000000000000000000000000000000000000000
