11111111111111111111111111111111111111111111111111111111111111111111111111111111
11111111111111111111111111111111111111111111111111111111111111111111111111111111
11111111111111111111111111111111111111111111111111111111111111111111111111111111
11111111111111111111111111111111111111111111111111111111111111111111111111111111
11111111111111111111111111111111111111111111111111111111111111111111111111111111
11111100000000000000001111111111111111111111111111111111111111111111111111111111
11111000000000000000000000000000000000000000000000000000000000111111111111111111
11111000000000000000000000000000000000000000000000000000000000111111111111111111
11111000000000000000000011111111111111111111111111111111111000111111111111111111
11111000000000000000000011111111111111111111111111111111111000111111111111111111
11111000011111111111111111111111111111111111111111111111111000111111111111111111
11111000011111111111111111111111111111111111111111111111111000111111111111111111
11111000011111111111111111111111111111111111111111111111111000111111111111111111
11111000011111111111111111111111111111111111111111111111111000111111111111111111
11111000011111111111111111111111111111111111111111111111111000111111111111111111
11111000011111111111111111111111111111111111111111111111111000111111111111111111
11111000011111111111111111111111111111111111111111111111111000111111111111111111
11111000011111111111111111111111111111111111111111111111111000111111111111111111
11111000011111111111111111111111111111111111111111111111111000000000000000011111
11111000011111111111111111111111111111111111111111111111111000000000000000011111
11111000011111111111111111111111111111111111111111111111111111111111111100011111
11111000011111111111111111111111111111111111111111111111111111111111111100011111
11111000011111111111111111111111111111111111111111111111111111111111111100011111
11111000011111111111111111111111111111111111111111111111111111111111111100011111
11111000011111111111111111111111111111111111111111111111111111111111111100011111
11111000011111111111111111111111111111111111111111111111111111111111111100011111
11111000011111111111111111111111111111111111111111111111111111111111111100011111
11111000011111111111111111111111111111111111111111111111111111111111111100011111
11111000011111111111111111111111111111111111111111111111111111111111111100011111
11111000011111111111111111111111111111111111111111111111111111111111111100011111
11111000000000000000000000000000000000000000000000000000000001111100000011011111
11111000000000000000000000000000000000000000000000000000000001111100000010011111
11111000000000000000000000000000000000000000000000000000000001111100000000011111
11111100000000000000000000000000000000000000000000000000000001111100000000011111
11111111111111111111111111111111111111111111111111111111100001111100001111111111
11111111111111111111111111111111111111111111111111111111100001111100001111111111
11111111111111111111111111111111111111111111111111111111100001111100001111111111
11111111111111111111111111111111111111111111111111111111100001111100001111111111
11111111111111111111111111111111111111111111111111111111100001111100001111111111
11111111111111111111111111111111111111111111111111111111100001111100001111111111
11111111111111111111111111111111111111111111111100000000000001111100001111111111
11111111111111111111111111111111111111111111111100000000000001111100001111111111
11111111111111111111111111111111111111111111110000000000000001111100001111111111
11111111111111111111111111111111111111111111110000000000000001111100001111111111
11111111111111111111111111111111111111111111000000001111111111111100001111111111
11111111111111111111111111111111111111111111000000001111111111111100001111111111
11111111111111111111111111111111111111111100000000111111111111111100001111111111
11111111111111111111111111111111111111111100000000111111111111111100001111111111
11111111111111111111111111111111111111110000000011111111111111111100001111111111
11111111111111111111111111111111111111110000000011111111111111111100001111111111
11111111111111111111111111111111111111000000001111111111111111111100001111111111
11111111111111111111111111111111111111000000001111111111111111111100001111111111
11111111111111111111111111111111111100000000111111111111111111111100001111111111
11111111111111111111111111111111111100000000111111111111111111111100001111111111
11111111111111111111111111111111111100000011111111111111111111111100001111111111
11111111111111111111111111111111111100000011111111111111111111111100001111111111
11111111111111111111111111111111111100001111111111111111111111111100001111111111
11111111111111111111111111111111111100001111111111111111111111111100001111111111
11111111111111111111111111111111111100001111111111111111111111111100001111111111
11111111111111111111111111111111111100001111111111111111111111111100001111111111
11111111111111111111111111111111111100001111111111111111111111111100001111111111
11111111111111111111111111111111111100001111111111111111111111111100001111111111
11111111111111111111111111111111111100001111111111111111111111111100001111111111
11111111111111111111111111111111111100001111111111111111111111111100001111111111
11111111111111111111111111111111111100001111111111111111111111111100001111111111
11111111111111111111111111111111111100001111111111111111111111111100001111111111
11111111111111111111111111111111111100001111111111111111111111111100001111111111
11111111111111111111111111111111111100001111111111111111111111111100001111111111
11111111111111111111111111111111111100001111111111111111111111111100001111111111
11111111111111111111111111111111111100001111111111111111111111111100001111111111
11111111111111111111111111111111111100001111111111111111111111111100001111111111
11111111111111111111111111111111111100000000000000000000000000000000001111111111
11111111111111111111111111111111111100000000000000000000000000000000001111111111
11111111111111111111111111111111111100000000000000000000000000000000001111111111
11111111111111111111111111111111111100000000000000000000000000000000001111111111
11111111111111111111111111111111111111111111111111111111111111111111111111111111
11111111111111111111111111111111111111111111111111111111111111111111111111111111
11111111111111111111111111111111111111111111111111111111111111111111111111111111
11111111111111111111111111111111111111111111111111111111111111111111111111111111
11111111111111111111111111111111111111111111111111111111111111111111111111111111
