00000000000000000000000000000000000000000000000000000000000000000000000000000001
00000000000000000000000000000000000000000000000000000000000000000000000000000000
00000000000000000000000000000000000000000000000000000000000000000000000000000000
00000000000000000000000000000000000000000000000000000000000000000000000000000000
00000000000000000000000000000000000000000000000000000000000000000000000000000000
00000000000000033333333000000000000000000000000000000000000000000000000000000000
00000000000000122222222100000000000000000000000000000000000000000000000000000000
00000000000000122222222100000000000000000000000000000000000000000000000000000000
00000000000000122222222100000000000000000000000000000000000000000000000000000000
00000000000000122222222100000000000000000000000000000000000000000000000000000000
00000000000000122222222100000000000000000000000000000000000000000000000000000000
00000000000000122222222100000000000000000000000000000000000000000000000000000000
00000000000000122222222300000000000000000000000000000000000000000000000000000000
00000000000000122222222300000000000000000000000000000000000000000000000000000000
00000000000000122222222300000000000000000000000000000000000000000000000000000000
00000000000000122222222300000000000000000000000000000000000000000000000000000000
00000000000000122222222300000000000000000000000000000000000000000000000000000000
00000000000000122222222300000000000000000000000000000000000000000000000000000000
00000000000000122222222300000000000000000000000000000000000000000000000000000000
00000000000000122222222300000000000000000000000000000000000000000000000000000000
00000000000000122222222300000000000000000000000000000000000000000000000000000000
00000000000000122222222300000000000000000000000000000000000000000000000000000000
00000000000000122222222300000000000000000000000000000000000000000000000000000000
00000000000000122222222300000000000000010000000000000000000000000000000000000000
00000000000000122222222333333333333333321000000000000000000000000000000000000000
00000000000000012222222222222222222222221000000000000000000000000000000000000000
00000000000000012222222222222222222222221000000000000000000000000000000000000000
00000000000000012222222222222222222222221000000000000000000000000000000000000000
00000000000000012222222222222222222222221000000000000000000000000000000000000000
00000000000000012222222222222222222222221000000000000000000000000000000000000000
00000000000000012222222222222222222222221000000000000000000000000000000000000000
00000000000000012222222222222222222222221000000000000000000000000000000000000000
00000000000000012222222222222222222222221000000000000000000000000000000000000000
00000000000000012222222222222222222222221000000000000000000000000000000000000000
00000000000000003333333333333333333333330000000000000000000000000000000000000000
00000000000000000000000000000000000000000000000000000000000000000000000000000000
00000000000000000000000000000000000000000000000000000000000000000000000000000000
00000000000000000000000000000000000000000000000000000000000000000000000000000000
00000000000000000000000000000000000000000000000000000000000000000000000000000000
00000000000000000000000000000000000000000000000000000000000000000000000000000000
00000000000000000000000000000000000000000000000000000000000000000000000000000000
00000000000000000000000000000000000000000000000000000000000000000000000000000000
00000000000000000000000000000000000000000000000000000000000000000000000000000000
00000000000000000000000000000000000000000000000000000000000000000000000000000000
00000000000000000000000000000000000000000000000000000000000000000000000000000000
00000000000000000000000000000000000000000000000000000000000000000000000000000000
00000000000000000000000000000000000000000000000000000000000000000000000000000000
00000000000000000000000000000000000000000000000000000000000000000000000000000000
00000000000000000000000000000000000000000000000000000000000000000000000000000000
00000000000000000000000000000000000000000000000000000000000000000000000000000000
00000000000000000000000000000000000000000000000000000000000000000000000000000000
00000000000000000000000000000000000000000000000000000000000000000000000000000000
00000000000000000000000000000000000000000000000000000000000000000000000000000000
00000000000000000000000000000000000000000000000000000000000000000000000000000000
00000000000000000000000000000000000000000000000000000000000000000000000000000000
00000000000000000000000000000000000000000000000000000000000000000000000000000000
00000000000000000000000000000000000000000000000000000000000000000000000000000000
00000000000000000000000000000000000000000000000000000000000000000000000000000000
00000000000000000000000000000000000000000000000000000000000000000000000000000000
00000000000000000000000000000000000000000000000000000000000000000000000000000000
00000000000000000000000000000000000000000000000000000000000000000000000000000000
00000000000000000000000000000000000000000000000000000000000000000000000000000000
00000000000000000000000000000000000000000000000000000000000000000000000000000000
00000000000000000000000000000000000000000000000000000000000000000000000000000000
00000000000000000000000000000000000000000000000000000000000000000000000000000000
00000000000000000000000000000000000000000000000000000000000000000000000000000000
00000000000000000000000000000000000000000000000000000000000000000000000000000000
00000000000000000000000000000000000000000000000000000000000000000000000000000000
00000000000000000000000000000000000000000000000000000000000000000000000000000000
00000000000000000000000000000000000000000000000000000000000000000000000000000000
00000000000000000000000000000000000000000000000000000000000000000000000000000000
00000000000000000000000000000000000000000000000000000000000000000000000000000000
00000000000000000000000000000000000000000000000000000000000000000000000000000000
00000000000000000000000000000000000000000000000000000000000000000000000000000000
00000000000000000000000000000000000000000000000000000000000000000000000000000000
00000000000000000000000000000000000000000000000000000000000000000000000000000000
00000000000000000000000000000000000000000000000000000000000000000000000000000000
00000000000000000000000000000000000000000000000000000000000000000000000000000000
00000000000000000000000000000000000000000000000000000000000000000000000000000000
00000000000000000000000000000000000000000000000000000000000000000000000000000000
