0000000000000000000000000000000000000000
0000000000000000000000000000000000000000
0000000000000000000000000000000000000000
0002222222222222222222222222210000000000
0003222222222222222222222222110000000000
0003322222222222222222222221110000000000
0003332222100000000222222114110000000000
0003333221100000000342221111421000000000
0003333311100000000033211111144000000000
0003333311100000000033311111114422221000
0003333311100000000033311111121332211000
0003333341100000000033441111222333111000
0003333444210000000034444112222233111000
0003334444444444444444444422222223411000
0003344444444444444444444444444314441000
0003444444444444444444444444443311444000
0000000000000000000000000000033311000000
0000000000000000000000000000033311000000
0000000000000000000000000000033311000000
0000000000000000000000000000033311000000
0000000000000000000000000000033311000000
0000000000000000000000002222233311000000
0000000000000000000000023222223311000000
0000000000000000000000232322222311000000
0000000000000000000002323232222111000000
0000000000000000000023232323221111000000
0000000000000000000232323232341111000000
0000000000000000002323232344431111000000
0000000000000000003232340000341111000000
0000000000000000003323100000031111000000
0000000000000000003332100000031111000000
0000000000000000003333100000031111000000
0000000000000000003333100000031111000000
0000000000000000003333210000234111000000
0000000000000000003334444444444411000000
0000000000000000003344444444444441000000
0000000000000000003444444444444444000000
0000000000000000000000000000000000000000
0000000000000000000000000000000000000000
0000000000000000000000000000000000000000
