00000000000000000000000000000000000000000000000000000000000000000000000000000001
00000000000000000000000000000000000000000000000000000000000000000000000000000000
00000000000000000000000000000000000000000000000000000000000000000000000000000000
00000000000000000000000000000000000000000000000000000000000000000000000000000000
00000000000000000000000000000000000000000000000000000000000000000000000000000000
00000000000000000000000000000000000000000000000000000000000000000000000000000000
00000000000000000000000000000000000000000000000000000000000000000000000000000000
00000000000000000000000000000000000000000000000000000000000000000000000000000000
00000000000000000000000000000000000000000000000000000000000000000000000000000000
00000000000000000003333333333333333333333330000000000000000000000000000000000000
00000000000000000032222222222222222222222221000000000000000000000000000000000000
00000000000000000032222233332223333333332221000000000000000000000000000000000000
00000000000000000032222230032223000000032221000000000000000000000000000000000000
00000000000000000032222230032223000000032221000000000000000000000000000000000000
00000000000000000032222230032223000000032221000000000000000000000000000000000000
00000000000000000032222230032223000000032221000000000000000000000000000000000000
00000000000000000032222230032223000000032221000000000000000000000000000000000000
00000000000000000032222230032223000000032221000000000000000000000000000000000000
00000000000000000032222230032223000000032221000000000000000000000000000000000000
00000000000000000032222230032223000000032221000000000000000000000000000000000000
00000000000000000032222230032223000000032221000000000000000000000000000000000000
00000000000000000032222230032223000000032221000000000000000000000000000000000000
00000000000000000032222230003333000000032221000000000000000000000000000000000000
00000000000000000032222230000000000000032221000000000000000000000000000000000000
00000000000000000032222230000000000000032221000000000000000000000000000000000000
00000000000000000003112233333333333333332221000000000000000000000000000000000000
00000000000000000000012222222222222222222221000000000000000000000000000000000000
00000000000000000000012222222222222222221221000000000000000000000000000000000000
00000000000000000000003322222222222222221221000000000000000000000000000000000000
00000000000000000000000322222222222222221221000000000000000000000000000000000000
00000000000000000000000322222222222222221221000000000000000000000000000000000000
00000000000000000000000322222222222222221221000000000000000000000000000000000000
00000000000000000000000322222222222222221221000000000000000000000000000000000000
00000000000000000000000033333333333333330330000000000000000000000000000000000000
00000000000000000000000000000000000000000000000000000000000000000000000000000000
00000000000000000000000000000000000000000000000000000000000000000000000000000000
00000000000000000000000000000000000000000000000000000000000000000000000000000000
00000000000000000000000000000000000000000000000000000000000000000000000000000000
00000000000000000000000000000000000000000000000000000000000000000000000000000000
00000000000000000000000000000000000000000000000000000000000000000000000000000000
00000000000000000000000000000000000000000000000000000000000000000000000000000000
00000000000000000000000000000000000000000000000000000000000000000000000000000000
00000000000000000000000000000000000000000000000000000000000000000000000000000000
00000000000000000000000000000000000000000000000000000000000000000000000000000000
00000000000000000000000000000000000000000000000000000000000000000000000000000000
00000000000000000000000000000000000000000000000000000000000000000000000000000000
00000000000000000000000000000000000000000000000000000000000000000000000000000000
00000000000000000000000000000000000000000000000000000000000000000000000000000000
00000000000000000000000000000000000000000000000000000000000000000000000000000000
00000000000000000000000000000000000000000000000000000000000000000000000000000000
00000000000000000000000000000000000000000000000000000000000000000000000000000000
00000000000000000000000000000000000000000000000000000000000000000000000000000000
00000000000000000000000000000000000000000000000000000000000000000000000000000000
00000000000000000000000000000000000000000000000000000000000000000000000000000000
00000000000000000000000000000000000000000000000000000000000000000000000000000000
00000000000000000000000000000000000000000000000000000000000000000000000000000000
00000000000000000000000000000000000000000000000000000000000000000000000000000000
00000000000000000000000000000000000000000000000000000000000000000000000000000000
00000000000000000000000000000000000000000000000000000000000000000000000000000000
00000000000000000000000000000000000000000000000000000000000000000000000000000000
00000000000000000000000000000000000000000000000000000000000000000000000000000000
00000000000000000000000000000000000000000000000000000000000000000000000000000000
00000000000000000000000000000000000000000000000000000000000000000000000000000000
00000000000000000000000000000000000000000000000000000000000000000000000000000000
00000000000000000000000000000000000000000000000000000000000000000000000000000000
00000000000000000000000000000000000000000000000000000000000000000000000000000000
00000000000000000000000000000000000000000000000000000000000000000000000000000000
00000000000000000000000000000000000000000000000000000000000000000000000000000000
00000000000000000000000000000000000000000000000000000000000000000000000000000000
00000000000000000000000000000000000000000000000000000000000000000000000000000000
00000000000000000000000000000000000000000000000000000000000000000000000000000000
00000000000000000000000000000000000000000000000000000000000000000000000000000000
00000000000000000000000000000000000000000000000000000000000000000000000000000000
00000000000000000000000000000000000000000000000000000000000000000000000000000000
00000000000000000000000000000000000000000000000000000000000000000000000000000000
00000000000000000000000000000000000000000000000000000000000000000000000000000000
00000000000000000000000000000000000000000000000000000000000000000000000000000000
00000000000000000000000000000000000000000000000000000000000000000000000000000000
00000000000000000000000000000000000000000000000000000000000000000000000000000000
00000000000000000000000000000000000000000000000000000000000000000000000000000000
