00000000000000000000000000000000000000000000000000000000000000000000000000000001
00000000000000000000000000000000000000000000000000000000000000000000000000000000
00000000000000000000000000000000000000000000000000000000000000000000000000000000
00000000000000000000000000000000000000000000000000000000000000000000000000000000
00000000000000000000000000000000000000000000000000000000000000000000000000000000
00000000000000000000000000000000000000000000000000000000000000000000000000000000
00000000000000000000000000000000000000000000000000000000000000000000000000000000
00000000000000000000000000000000000000000000000000000000000000000000000000000000
00000000000000000000000000000000000000000000000000000000000000000000000000000000
00000000000000000003333300000000000000003333333333000000000000000000000000000000
00000000000000000032222210000000000000012222222222100000000000000000000000000000
00000000000000000032222230000000000000032222222222100000000000000000000000000000
00000000000000000032222230000000000000032222222222100000000000000000000000000000
00000000000000000032222230000000000000032222222222100000000000000000000000000000
00000000000000000032222230000000000000032222222222100000000000000000000000000000
00000000000000000032222230000000000000032222222222100000000000000000000000000000
00000000000000000032222230000000000000032222222222100000000000000000000000000000
00000000000000000032222230000000000000032222222222100000000000000000000000000000
00000000000000000032222230000000000000032222222222100000000000000000000000000000
00000000000000000032222230000000000000032222222222100000000000000000000000000000
00000000000000000032222230000000000000032222222222210000000000000000000000000000
00000000000000000032222230000000000000032222233333300000000000000000000000000000
00000000000000000032222230000000000000032222230000000000000000000000000000000000
00000000000000000032222230000000000000032222230000000000000000000000000000000000
00000000000000000032222230000000000000032222230000000000000000000000000000000000
00000000000000000003322233333333333333332222230000000000000000000000000000000000
00000000000000000000322222222222222222222222230000000000000000000000000000000000
00000000000000000000322222222222222222222222230000000000000000000000000000000000
00000000000000000000033312222222222222222222230000000000000000000000000000000000
00000000000000000000000032222222222222222222230000000000000000000000000000000000
00000000000000000000000032222222222222222222230000000000000000000000000000000000
00000000000000000000000032222222222222222222230000000000000000000000000000000000
00000000000000000000000032222222222222222222230000000000000000000000000000000000
00000000000000000000000003333333333333333333300000000000000000000000000000000000
00000000000000000000000000000000000000000000000000000000000000000000000000000000
00000000000000000000000000000000000000000000000000000000000000000000000000000000
00000000000000000000000000000000000000000000000000000000000000000000000000000000
00000000000000000000000000000000000000000000000000000000000000000000000000000000
00000000000000000000000000000000000000000000000000000000000000000000000000000000
00000000000000000000000000000000000000000000000000000000000000000000000000000000
00000000000000000000000000000000000000000000000000000000000000000000000000000000
00000000000000000000000000000000000000000000000000000000000000000000000000000000
00000000000000000000000000000000000000000000000000000000000000000000000000000000
00000000000000000000000000000000000000000000000000000000000000000000000000000000
00000000000000000000000000000000000000000000000000000000000000000000000000000000
00000000000000000000000000000000000000000000000000000000000000000000000000000000
00000000000000000000000000000000000000000000000000000000000000000000000000000000
00000000000000000000000000000000000000000000000000000000000000000000000000000000
00000000000000000000000000000000000000000000000000000000000000000000000000000000
00000000000000000000000000000000000000000000000000000000000000000000000000000000
00000000000000000000000000000000000000000000000000000000000000000000000000000000
00000000000000000000000000000000000000000000000000000000000000000000000000000000
00000000000000000000000000000000000000000000000000000000000000000000000000000000
00000000000000000000000000000000000000000000000000000000000000000000000000000000
00000000000000000000000000000000000000000000000000000000000000000000000000000000
00000000000000000000000000000000000000000000000000000000000000000000000000000000
00000000000000000000000000000000000000000000000000000000000000000000000000000000
00000000000000000000000000000000000000000000000000000000000000000000000000000000
00000000000000000000000000000000000000000000000000000000000000000000000000000000
00000000000000000000000000000000000000000000000000000000000000000000000000000000
00000000000000000000000000000000000000000000000000000000000000000000000000000000
00000000000000000000000000000000000000000000000000000000000000000000000000000000
00000000000000000000000000000000000000000000000000000000000000000000000000000000
00000000000000000000000000000000000000000000000000000000000000000000000000000000
00000000000000000000000000000000000000000000000000000000000000000000000000000000
00000000000000000000000000000000000000000000000000000000000000000000000000000000
00000000000000000000000000000000000000000000000000000000000000000000000000000000
00000000000000000000000000000000000000000000000000000000000000000000000000000000
00000000000000000000000000000000000000000000000000000000000000000000000000000000
00000000000000000000000000000000000000000000000000000000000000000000000000000000
00000000000000000000000000000000000000000000000000000000000000000000000000000000
00000000000000000000000000000000000000000000000000000000000000000000000000000000
00000000000000000000000000000000000000000000000000000000000000000000000000000000
00000000000000000000000000000000000000000000000000000000000000000000000000000000
00000000000000000000000000000000000000000000000000000000000000000000000000000000
00000000000000000000000000000000000000000000000000000000000000000000000000000000
00000000000000000000000000000000000000000000000000000000000000000000000000000000
00000000000000000000000000000000000000000000000000000000000000000000000000000000
00000000000000000000000000000000000000000000000000000000000000000000000000000000
00000000000000000000000000000000000000000000000000000000000000000000000000000000
