00000000000000000000000000000000000000000000000000000000000000000000000000000000
00000000000000000000000000000000000000000000000000000000000000000000000000000000
00000000000000000000000000000000000000000000000000000000000000000000000000000000
00000000000000000000000000000000000000000000000000000000000000000000000000000000
00000000000000000000000000000000000000000000000000000000000000000000000000000000
00000022222222222222233333333333333333333333333333333333333333000000000000000000
00000322222222222222222222222222222222222222222222222222222222300000000000000000
00000322222222222222222222222222222222222222222222222222222222300000000000000000
00000322111111111111111222222222222222222222222222222222222222300000000000000000
00000322222222222222222222222222222222222222222222222222222222300000000000000000
00000322222222222222222222222222222222222222222222222222222222300000000000000000
00000322222222222222222222222222222222222222222222222222222222300000000000000000
00000322222222222222222233322222222222222222222222222212222222300000000000000000
00000322222222222222222230000000000000322222222222222212222222300000000000000000
00000322222221111111122230000000000000322222222222222212222222300000000000000000
00000322222221000000122230000000000000322222221111222212222222300000000000000000
00000322222221000000122230000000000000322222221001222212222222300000000000000000
00000322222221000000122230000000000000322222221222222212222222333333333333300000
00000322222221000000122230000000000000322222221222222212222222222222222222230000
00000322222221000000122230000000000000322222222222222212222222222222222222230000
00000322222221000000122230000000000000321222222222222212222222222222222222230000
00000322222221000000122230000000000000321222122222222212222222222222222222230000
00000322222221000000122230000000000000321222122222222212222222222222222222230000
00000322222221000000122230000000000000321222122222222212222222222222222222230000
00000322222221000000122222222222222222321222122222222222111112222222222222230000
00000322222221000000121222222222222222221222122222222111111112222222222222230000
00000322222221111111122222222222222222222222222222222222222222222222222222230000
00000322222222222222222222222222222222222222222222222222222222221111122222230000
00000322222222222222222222222222222222222222222222222222222222222222222222230000
00000322222222222222222222222222222222222222222222222222222222222222222222230000
00000322222222222222222222222222222222222222222222222222222222222222222222230000
00000322222222222222222222222222222222222222222222222222222222222222222222230000
00000322222222222222222222222222222222222222222222222222222222222222222222230000
00000032222222222222222222222222222222222222222222222222222222222222223333300000
00000000000000000000000000000033333333333333333333333333332222222222223000000000
00000000000000000000000000000000000000000000000000000000032222222222223000000000
00000000000000000000000000000000000000000000000000000000032222222222223000000000
00000000000000000000000000000000000000000000000000000000032222222222223000000000
00000000000000000000000000000000000000000000000000000000032222222222223000000000
00000000000000000000000000000000000000000000000000000000032222222222223000000000
00000000000000000000000000000000000000000000000022222222232222222222223000000000
00000000000000000000000000000000000000000000000032222222222222222222223000000000
00000000000000000000000000000000000000000000000032222222222222222222223000000000
00000000000000000000000000000000000000000000000032222222222222222222223000000000
00000000000000000000000000000000000000000000000032222222222222222222223000000000
00000000000000000000000000000000000000000000000032222222222222222222223000000000
00000000000000000000000000000000000000000000000032222222222222222222223000000000
00000000000000000000000000000000000000000000000032222222222222222222223000000000
00000000000000000000000000000000000000000000000032222222222222222222223000000000
00000000000000000000000000000000000000033333333332222222222222222222220000000000
00000000000000000000000000000000000000322222222222222222222222222222220000000000
00000000000000000000000000000000000000322222222222222222222222222222220000000000
00000000000000000000000000000000000000321222222222222222222222222222220000000000
00000000000000000000000000000000000333321222222222222222222222222222220000000000
00000000000000000000000000000000003222221222222222222222222222222222220000000000
00000000000000000000000000000000003212222222222222222222222222222222220000000000
00000000000000000000000000000000003212222222222222222222222222222222220000000000
00000000000000000000000000000000003212222222222222222222222222222222220000000000
00000000000000000000000000000000003212222222221233333333222222222222220000000000
00000000000000000000000000000000003212222222222230000000322222222222220000000000
00000000000000000000000000000000003212222222222230000000322222222222220000000000
00000000000000000000000000000000003212222222222300000000322222222222220000000000
00000000000000000000000000000000003212222222222300000000322222222222220000000000
00000000000000000000000000000000003212222222222300000000322222222222220000000000
00000000000000000000000000000000003212222222112330000000322222222222220000000000
00000000000000000000000000000000003212222222112223000000322222222222220000000000
00000000000000000000000000000000003212222222222223333333322222222222220000000000
00000000000000000000000000000000003212222222222222222222222222222222220000000000
00000000000000000000000000000000003212222222222222222222222222222222220000000000
00000000000000000000000000000000003212222222222222222222222222222222220000000000
00000000000000000000000000000000003222222222222222222222222222222222220000000000
00000000000000000000000000000000003222222222222222222222222222222222220000000000
00000000000000000000000000000000003222222222222222222222222222222222220000000000
00000000000000000000000000000000003222222222222222222222222222222222220000000000
00000000000000000000000000000000003222222222222222222222222222222222230000000000
00000000000000000000000000000000000333333333333333333333333333333333300000000000
00000000000000000000000000000000000000000000000000000000000000000000000000000000
00000000000000000000000000000000000000000000000000000000000000000000000000000000
00000000000000000000000000000000000000000000000000000000000000000000000000000000
00000000000000000000000000000000000000000000000000000000000000000000000000000000
