0000000000000000000000000000000000000000000000000000000000000000000000000000000«
00000000000000000000000000000000000000000000000000000000000000000000000000000000
00000000000000000000000000000000000000000000000000000000000000000000000000000000
00000000000000000000000000000000000000000000000000000000000000000000000000000000
00000000000000000000000000000000000000000000000000000000000000000000000000000000
00000000000000000000000000000000000000000000000000000000000000000000000000000000
00000000000000000000000000000000000000000000000000000000000000000000000000000000
00000000000000000000000003333333333330000000000000000000000000000000000000000000
00000000000000000000000032222222222222000000000000000000000000000000000000000000
00000000000000000000000032222222222222000000000000000000000000000000000000000000
00000000000000000000000032222222222222000000000000000000000000000000000000000000
00000000000000000000000032222222222222000000000000000000000000000000000000000000
00000000000000000000000032222222222222000000000000000000000000000000000000000000
00000000000000000000000032222222222222000000000000000000000000000000000000000000
00000000000000000000000032222222222222000000000000000000000000000000000000000000
00000000000000000000000032222222222222000000000000000000000000000000000000000000
00000000000000000000000032222222222222000000000000000000000000000000000000000000
00000000000000000000000032222222222222000003333333333333333300000000000000000000
00000000000000000000000032222222222222000032222222222222222230000000000000000000
00000000000000000000000032222222222222000032222222222222222230000000000000000000
00000000000000000000000032222222222222000032222222222222222230000000000000000000
00000000000000000000000032222222222222000032222222222222222230000000000000000000
00000000000000000000000032222222222222000032222222222222222230000000000000000000
00000000033333333333333332222222222222000032222222222222222230000000000000000000
00000000322222222222222222222222222222000032222222222222222230000000000000000000
00000000322222222222222222222222222222000032222222222222222230000000000000000000
00000000322222222222222222222222222222000032222222222222222230000000000000000000
00000000322222222222222222222222222222000032222222222222222230000000000000000000
00000000322222222222222222222222222222000032222222222222222230000000000000000000
00000000322222222222222222222222222222000032222222222222222230000000000000000000
00000000322222222222222222222222222223333232222222222222222230000000000000000000
00000000322222222222222222222222222222222222222222222222222230000000000000000000
00000000322222222222222222222222222222222222222222222222222230000000000000000000
00000000322222222222222222222222222222222222222222222222222230000000000000000000
00000000322222222222222222222222222222222222222222222222222230000000000000000000
00000000322222222222222222222222222222222222222222222222222230000000000000000000
00000000322222222222222222222222222222222222222222222222222230000000000000000000
00000000322222222222222222222222222222222222222222222222222230000000000000000000
00000000033333333333333333333322222222222222222222222222222230000000000000000000
00000000000000000000000000000322222222222222222222333333333300000000000000000000
00000000000000000000000000000322222222222222222222300000000000000000000000000000
00000000000000000000000000000322222222222222222222300000000000000000000000000000
00000000033333333333333333333322222222222222222222300000000000000000000000000000
00000000322222222222222222222222222222222222222222333333333333333333333300000000
00000000322222222222222222222222222222222222222222222222222222222222222230000000
00000000322222222222222222222222222222222222222222222222222222222222222230000000
00000000322222222222222222222222222222222222222222222222222222222222222230000000
00000000322222222222222222222222222222222222222222222222222222222222222230000000
00000000322222222222222222222222222222222222222222222222222222222222222230000000
000000003222222222222222222222222222222222222222222222222222222222222222300000