0000000000000000000000000000000000000000000000000000000000000000000000000000000š
00000000000000000000000000000000000000000000000000000000000000000000000000000000
00000000000000000000000000000000000000000000000000000000000000000000000000000000
00000000000000000000000000000000000000000000000000000000000000000000000000000000
00000000000000000000000000000000000000000000000000000000000000000000000000000000
00000000000000000000000000000000000000000000000000000000000000000000000000000000
00000000000000000000000000000000000000000000000000000000000000000000000000000000
00000000000000000000000003333333333330000000000000000000000000000000000000000000
00000000000000000000000032222222222222000000000000000000000000000000000000000000
00000000000000000000000032222222222222000000000000000000000000000000000000000000
00000000000000000000000032222222222222000000000000000000000000000000000000000000
00000000000000000000000032222222222222000000000000000000000000000000000000000000
00000000000000000000000032221000012222000000000000000000000000000000000000000000
00000000000000000000000032221000012222000000000000000000000000000000000000000000
00000000000000000000000032221000012222000000000000000000000000000000000000000000
00000000000000000000000032221000012222000000000000000000000000000000000000000000
00000000000000000000000032221000012222000000000000000000000000000000000000000000
00000000000000000000000032221000012222000003333333333333333300000000000000000000
00000000000000000000000032221000012222000032222222222222222230000000000000000000
00000000000000000000000032221000012222000032222222222222222230000000000000000000
00000000000000000000000032221000012222000032222222222222222230000000000000000000
00000000000000000000000032221000012222000032222222222222222230000000000000000000
00000000000000000000000032221000012222000032221000000000122230000000000000000000
00000000033333333333333332221000012222000032221000000000122230000000000000000000
00000000322222222222222222221000012222000032221000000000122230000000000000000000
00000000322222222222222222221000012222000032221000000000122230000000000000000000
00000000322222222222222222221000012222000032221000000000122230000000000000000000
00000000322222222222222222220000012222000032221000000000122230000000000000000000
00000000322210000000000000000000012222000032221000000000122230000000000000000000
00000000322210000000000000000000012222000032221000000000122230000000000000000000
00000000322210000000000000000000012223333232221000000000122230000000000000000000
00000000322210000000000000000000012222222222221000000000122230000000000000000000
00000000322210000000000000000000012222222222221000000000122230000000000000000000
00000000322210000000000000000000012222222222221000000000122230000000000000000000
00000000322211111111111111111111122222222222221000000000122230000000000000000000
00000000322222222222222222222222222222222222110222222222222230000000000000000000
00000000322222222222222222222222222111111111001222222222222230000000000000000000
00000000322222222222222222222222222000000000001222222222222230000000000000000000
00000000033333333333333333333322222000000000001222222222222230000000000000000000
00000000000000000000000000000322222000000000001222333333333300000000000000000000
00000000000000000000000000000322222000000000001222300000000000000000000000000000
00000000000000000000000000000322222000000000001222300000000000000000000000000000
00000000033333333333333333333322222000000000001222300000000000000000000000000000
00000000322222222222222222222222222000000000001222333333333333333333333300000000
00000000322222222222222222222222222000000000001222222222222222222222222230000000
00000000322222222222222222222222222000000000001222222222222222222222222230000000
00000000322222222222222222222222222222222222221222222222222222222222222230000000
00000000322222222222222222222222222222222222220111111111111111111111122230000000
00000000322222222222222222222222222222222222220000000000000000000000122230000000
00000000322222222222222222222222222222222222220000000000000000000000122230000000
00000000322222222222222222222222222223333322220000000000000000000000122230000000
00000000322222221111111111111112222223000322220000000000000000000000122230000000
00000000322222221000000000000012222223000322220000000000000000000000122230000000
00000000322222221000000000000012222223000322220000000000000000000000122230000000
00000000322222221000000000000012222223000322220000000000000000000000122230000000
00000000322222221111111100000012222223000322220000000000000000000000122230000000
00000000322222222222222222222222222223000322220000000000000000000000122230000000
00000000322222222222222222222222222223000322220000000000000000000000122230000000
00000000322222222222222222222222222223000322220000000000000000000000122230000000
00000000322222222222222222222222222223000322220000000000000000000000122230000000
00000000322222222222222222222222222223000322220000000000000000000000122230000000
00000000322222222222222222222222222223000322220000000000000000000000122230000000
00000000322222222222222222222222222223000322220000000000000000000000122230000000
00000000033333333333333333333333333330000322220000000000000000000000122230000000
00000000000000000000000000000000000000000322220000000000000000000000122230000000
00000000000000000000000000000000000000000322220000000000000000000000122230000000
00000000000000000000000000000000000000000322220000000000000000000000122230000000
00000000000000000000000000000000000000000322220000000000000000011111122230000000
00000000000000000000000000000000000000000322222222222222222222222222222230000000
00000000000000000000000000000000000000000322222222222222222222222222222230000000
00000000000000000000000000000000000000000322222222222222222222222222222230000000
00000000000000000000000000000000000000000322222222222222222222222222222200000000
00000000000000000000000000000000000000000033333333333333333333000000000000000000
00000000000000000000000000000000000000000000000000000000000000000000000000000000
00000000000000000000000000000000000000000000000000000000000000000000000000000000
00000000000000000000000000000000000000000000000000000000000000000000000000000000
00000000000000000000000000000000000000000000000000000000000000000000000000000000
00000000000000000000000000000000000000000000000000000000000000000000000000000000
00000000000000000000000000000000000000000000000000000000000000000000000000000000
00000000000000000000000000000000000000000000000000000000000000000000000000000000
