0000000000000000000000000000000000000000
0000000000000000000000000000000000000000
0000000000000000000000000000000000000000
0000000210022222222100000000000000000000
0000000322232222221100000000000000000000
0000000032223222211100000000000000000000
0000000030322300111100000000000000000000
0000000032332222111100000000000000000000
0000000033233221111210000000000000000000
0000000033433144112110000022222221000000
0000000030333103121110022232222211000000
0000000032333100211110003223222111000000
0000000033233222111110023322321111000000
0000000033323321111110032332231111000000
0000000033332344111110033233211111000000
0000000033334444411110033343441111000000
0000000033344444311110033434444111000000
0000000033144443311110030344444411000000
0000000033114433411110034444444441000000
0000000033410334311110000144444431000000
0000000034440343311110022114444331000000
0000000000000033341110034111443331000000
0000000000000033444110030112233344000000
0000000000000031444410000122233000000000
0000000000000031144440022222223000000000
0000000000000031100000032222221000000000
0000000000000031222222233222211000000000
0210000222100032222222223322111000000000
0310002321100033222222222331112221444400
0310003231222233314444444331122211000000
0322223342222223311444443331222112222210
0344441444444432311000033331444122222110
0000034000000333111000033334144444444110
0000003444400333111001033344414444444410
0000003000000333411001033444441444444440
0000003000000334311441034444444000000000
0000000000000343311031000000000000000000
0000000000000033441032222100000000000000
0000000000000034444034444400000000000000
0000000000000000000000000000000000000000
