0000000000000000000000000000000000000000000000000000000000000000000000000000000n
00000000000000000000000000000000000000000000000000000000000000000000000000000000
00000000000000000000000000000000000000000000000000000000000000000000000000000000
00000000000000000000000000000000000000000000000000000000000000000000000000000000
00000000000000000000000000000000000000000000000000000000000000000000000000000000
00000022222222222222220000000000000000000000000000000000000000000000000000000000
00000222222222222222222222222222222222222222222222222222222222000000000000000000
00000222222222222222222222222222222222222222222222222222222222000000000000000000
00000222222222222222222200000000000000000000000000000000000222000000000000000000
00000222222222222222222200000000000000000000000000000000000222000000000000000000
00000222200000000000000000000000000000000000000000000000000222000000000000000000
00000222200000000000000000000000000000000000000000000000000222000000000000000000
00000222200000000000000000000000000000000000000000000000000222000000000000000000
00000222200000000000000000000000000000000000000000000000000222000000000000000000
00000222200000000000000000000000000000000000000000000000000222000000000000000000
00000222200000000000000000000000000000000000000000000000000222000000000000000000
00000222200000000000000000000000000000000000000000000000000222000000000000000000
00000222200000000000000000000000000000000000000000000000000222000000000000000000
00000222200000000000000000000000000000000000000000000000000222222222222222200000
00000222200000000000000000000000000000000000000000000000000222222222222222200000
00000222200000000000000000000000000000000000000000000000000000000000000022200000
00000222200000000000000000000000000000000000000000000000000000000000000022200000
00000222200000000000000000000000000000000000000000000000000000000000000022200000
00000222200000000000000000000000000000000000000000000000000000000000000022200000
00000222200000000000000000000000000000000000000000000000000000000000000022200000
00000222200000000000000000000000000000000000000000000000000000000000000022200000
00000222200000000000000000000000000000000000000000000000000000000000000022200000
00000222200000000000000000000000000000000000000000000000000000000000000022200000
00000222200000000000000000000000000000000000000000000000000000000000000022200000
00000222200000000000000000000000000000000000000000000000000000000000000022200000
00000222222222222222222222222222222222222222222222222222222220000022222222200000
00000222222222222222222222222222222222222222222222222222222220000022222222200000
00000222222222222222222222222222222222222222222222222222222220000022222222200000
00000022222222222222222222222222222222222222222222222222222220000022222222200000
00000000000000000000000000000000000000000000000000000000022220000022220000000000
00000000000000000000000000000000000000000000000000000000022220000022220000000000
00000000000000000000000000000000000000000000000000000000022220000022220000000000
00000000000000000000000000000000000000000000000000000000022220000022220000000000
00000000000000000000000000000000000000000000000000000000022220000022220000000000
00000000000000000000000000000000000000000000000000000000022220000022220000000000
00000000000000000000000000000000000000000000000022222222222220000022220000000000
00000000000000000000000000000000000000000000000022222222222220000022220000000000
00000000000000000000000000000000000000000000002222222222222220000022220000000000
00000000000000000000000000000000000000000000002222222222222220000022220000000000
00000000000000000000000000000000000000000000222222220000000000000022220000000000
00000000000000000000000000000000000000000000222222220000000000000022220000000000
00000000000000000000000000000000000000000022222222000000000000000022220000000000
00000000000000000000000000000000000000000022222222000000000000000022220000000000
00000000000000000000000000000000000000002222222200000000000000000022220000000000
000000000000000000000000000000000000000022222222000000000000000000222200000000