00000000000000000000000000000000000000000000000000000000000000000000000000000001
00000000000000000000000000000000000000000000000000000000000000000000000000000000
00000000000000000000000000000000000000000000000000000000000000000000000000000000
00000000000000000000000000000000000000000000000000000000000000000000000000000000
00000000000000000000000000000000000000000000000000000000000000000000000000000000
00000033333333333333333333333333333333333333333333333333333330000000000000000000
00000322222222222222222222222222222222222222222222222222222223000000000000000000
00000322222222222222222222222222222222222222222222222222222223000000000000000000
00000322222222222222222222222222222222222222222222222222222223000000000000000000
00000322222222222222222222222222222222222222222222222222222223000000000000000000
00000322222222222222222222222222222222222222222222222222222223000000000000000000
00000322222222222222222222222222222222222222222222222222222223000000000000000000
00000322222222222222222333333333333333322222222222222222222223000000000000000000
00000322222222222222222300000000000000322222222222222222222223000000000000000000
00000322222222222222222300000000000000322222222222222222222223000000000000000000
00000322222222222222222300000000000000322222222222222222222223000000000000000000
00000322222222222222222300000000000000322222222222222222222223300000000000000000
00000322222222222222222300000000000000322222222222222222222222233333333333000000
00000322222222222222222300000000000000322222222222222222222222222222222222300000
00000322222222222222222300000000000000322222222222222222222222222222222222300000
00000322222222222222222300000000000000322222222222222222222222222222222222300000
00000322222222222222222300000000000000322222222222222222222222222222222222300000
00000322222222222222222300000000000000322222222222222222222222222222222222300000
00000322222222222222222300000000000000322222222222222222222222222222222222300000
00000322222222222222222333333333333333322222222222222222222222222222222222300000
00000322222222222222222222222222222222222222222222222222222222222222222222300000
00000322222222222222222222222222222222222222222222222222222222222222222222300000
00000322222222222222222222222222222222222222222222222222222222222222222222300000
00000322222222222222222222222222222222222222222222222222222222222222222222300000
00000322222222222222222222222222222222222222222222222222222222222222222222300000
00000322222222222222222222222222222222222222222222222222222222222222222222300000
00000322222222222222222222222222222222222222222222222222222222222222222222300000
00000322222222222222222222222222222222222222222222222222222222222222222222300000
00000033333333322222222222222222222222222222222222222222222222222222223333000000
00000000000000033333333333333333333333333333333333333333332222222222223000000000
00000000000000000000000000000000000000000000000000000000032222222222223000000000
00000000000000000000000000000000000000000000000000000000032222222222223000000000
00000000000000000000000000000000000000000000000000000000032222222222223000000000
00000000000000000000000000000000000000000000000000000000032222222222223000000000
00000000000000000000000000000000000000000000000000000000032222222222223000000000
00000000000000000000000000000000000000000000000003333333332222222222223000000000
00000000000000000000000000000000000000000000000332222222222222222222223000000000
00000000000000000000000000000000000000000000003222222222222222222222223000000000
00000000000000000000000000000000000000000000033222222222222222222222223000000000
00000000000000000000000000000000000000000003322222222222222222222222223000000000
00000000000000000000000000000000000000000032322222222222222222222222223000000000
00000000000000000000000000000000000000000032222222222222222222222222223000000000
00000000000000000000000000000000000000000332222222222222222222222222223000000000
00000000000000000000000000000000000000003222222222222222222222222222223000000000
00000000000000000000000000000000000000033222222222222222222222222222223000000000
00000000000000000000000000000000000000322222222222222222222222222222223000000000
00000000000000000000000000000000000003322222222222222222222222222222223000000000
00000000000000000000000000000000000032222222222222222222222222222222223000000000
00000000000000000000000000000000000332222222222222222222222222222222223000000000
00000000000000000000000000000000003222222222222222222222222222222222223000000000
00000000000000000000000000000000003222222222222222222222222222222222223000000000
00000000000000000000000000000000003222222222222222222222222222222222223000000000
00000000000000000000000000000000003222222222222222233223222222222222223000000000
00000000000000000000000000000000003222222222222223300333222222222222223000000000
00000000000000000000000000000000003222222222222330000000322222222222223000000000
00000000000000000000000000000000003222222222222300000000322222222222223000000000
00000000000000000000000000000000003222222222222300000000322222222222223000000000
00000000000000000000000000000000003222222222222300000000322222222222223000000000
00000000000000000000000000000000003222222222222300000000322222222222223000000000
00000000000000000000000000000000003222222222222300000000322222222222223000000000
00000000000000000000000000000000003222222222222230000000322222222222223000000000
00000000000000000000000000000000003222222222222233000003322222222222223000000000
00000000000000000000000000000000003222222222222222333332222222222222223000000000
00000000000000000000000000000000003222222222222222222222222222222222223000000000
00000000000000000000000000000000003222222222222222222222222222222222223000000000
00000000000000000000000000000000003222222222222222222222222222222222223000000000
00000000000000000000000000000000003222222222222222222222222222222222223000000000
00000000000000000000000000000000003222222222222222222222222222222222223000000000
00000000000000000000000000000000003222222222222222222222222222222222223000000000
00000000000000000000000000000000003222222222222222222222222222222222223000000000
00000000000000000000000000000000000333333333333333333333333333333333330000000000
00000000000000000000000000000000000000000000000000000000000000000000000000000000
00000000000000000000000000000000000000000000000000000000000000000000000000000000
00000000000000000000000000000000000000000000000000000000000000000000000000000000
00000000000000000000000000000000000000000000000000000000000000000000000000000000
